下载	把 信息 从 互联网 或 其他 电子计算机 上 输入 到 某台 电子计算机 上 跟上 载 相对
注册	把 名字 记入 簿册 多指 取得 某种 资格
管理	主持 或 负责 某项 工作
使用	使人 或物 为 某种 目的 服务
进行	向前 行走
服务	履行 职务 为 大家 做事
发展	事物 由小到大 由 简单 到 复杂 由 低级 到 高级 的 变化
就是	作 副词 用 在 名词 动词 或 词组 前面 表示 某种 确定 的 范围 排斥 其他 相当于 仅 只有
提供	供给
相关	彼此 关连 相互 牵涉 互相关心
发表	在 报刊 上 登载 出来
所有	占有 有 支配权
开始	着手 进行 从头 起 从 某 一点 起
发布	宣布 发表
支持	支撑 撑住
联系	互相 之间 取得 联通 关系
积分	找出 被积 函数 中一 函数 或解 一 微分方程 的 演算
游戏	游乐 玩耍
通过	从 一端 到 另一端
不是	过错 过失 缺点
设计	按照 任务 的 目的 和 要求 预先 定出 工作 方案 和 计划 绘出 图样
活动	ó ò 的 又 音义 同 活动 ó ò
推荐	介绍 好 的 人 或事物 希望 被 任用 或 接受
评论	批评 或 议论 的 文章
生产	用 工具 创造 各种 生活资料 和 生产资料
选择	从 一群 或 一组 中 挑选
来自	表示 来源 但 通常 不 带有 肇始 之意 而 指 从 原有 的 以 另 一 形式 存在 的 人 或物 通过 赋 与 移转 演绎 模仿 或 再生 而 发生
成为	变成 魏书 崔鸿 传自   晋   永   以后 虽 所在 称兵 竞 自尊 树而能 建邦 命氏 成为 战国 者 十有 六家 二十年 目睹 之 怪现状 第一回 所以 那 空心 大老官 居然 成为   上海   的 土 产物 茅盾 子夜 三 自从 她 成为 这里 的 主妇 以来 这 缺少 了 什么 的 感觉 即使 时隐时现 可是 总常 在 她 心头
教育	培养人才 传播 知识 的 工作 主要 指 学校 教育
不会	不 领会 不 知道 唐   元稹 进 田弘正 碑文 状臣 若 苟务 文章 广徵 经典 非唯将吏 不会 亦 恐   弘正   未详 宋   周邦彦 南乡子 词 不会 沉吟 思底 事 凝眸 两点 春山 满镜愁
出现	显露出来
知道	动对 事情 或 道理 已经 了解 认识 懂得
介绍	沟通 使 双方 相识 或 发生 联系
建设	创立 新 事业 增加 新 设施 充实 新 精神
阅读	看 察看 ～ 览 ～ 读翻 ～ 传 á～ 批 ～ 订 ～ 检 ～～ 兵
回复	答复 多指 用 书信
学习	通过 阅读 听讲 研究 实践 等 获得 知识 或 技能 的 过程
有关	有 关系 关涉 涉及
开发	以 荒地 矿山 森林 水力 等 自然资源 为 对象 进行 劳动 以 达到 利用 的 目的 开拓
研究	钻研 探索
更新	旧 的 去 了 新 的 到来
显示	明显 地 表示
查看	检查 察看 事物 的 情况
无法	没辙 想不出 办法
投资	投入 资金
进入	步入 某一 特定 时期
发生	原来 不 存在 的 事情 出现 了
认为	把 看作 把 当作
搜索	寻求 搜查 韩非子 外储 说 左 下臣 居   鲁树三人 皆 为 令 尹及   虎   抵罪 於   鲁 皆 搜索 於   虎   也 南朝   宋   刘义庆 世说新语 政事 谢公   时兵 厮 逋 亡 多 近 窜   南塘   下 诸舫 中 或 欲求 一时 搜索 谢公   不许 明   胡应麟 诗 薮 六朝 大抵 六朝 文士 搜索 G题 一时 闺阁 传闻 m 形 楮 墨徐 怀中 西线 轶事 八在 树棵里 搜索 了 好久 什么 也 没有 发现
销售	出售
组织	按照 一定 的 目的 任务 和 形式 加以 编制 安排 事物 使 有 系统 或 构成 整体
说明	解释 清楚 讲明
提高	使 位置 程度 水平 数量质量 等 方面 比 原来 高
喜欢	愉快 高兴
经营	筹划 经管 组织 计划
作为	所作所为 行为
运行	星球 车船 等 周而复始 地 运转
解决	处理 使 有 结果
操作	劳动 劳作
经验	从 多次 实践 中 得到 的 知识 或 技能
登录	列入 记载
合作	互相配合 做 某事 或 共同完成 某项 任务
结果	长出 果实
影响	呼应 策应
表示	用 言行 表现 出
包括	包含 总括
规定	法律 用词 预先 制定 规则 以 作为 行为 的 标准 如在 合同 条约 契约 遗嘱 法律 中
处理	处置 安排 料理
具有	拥有 财产 附属物 属性 或 其他 附属 的 特征 等
关系	ā ì 的 又 音义 同 关系 ā ì
比较	对比 几种 同类 事物 的 异同 高下
分析	将 事物 现象 概念 分门别类 离 析出 本质 及其 内在联系
得到	获得
成功	成就 功业 政绩 或 事业
欢迎	高兴 地 迎接 来访者
加入	进入 参加
觉得	有 某种 感觉
控制	掌握住 对象 不使 任意 活动 或 超出范围 或 使 其 按 控制者 的 意愿 活动 控制 羊毛 市场 控制 不住 自己 的 感情
实现	使 成为 现实 我 决心 提前 五年 攻 下落 铃关 实现 毛主席 和   周总理 的 遗愿 为了 周总理 的 嘱托
出来	从 里面 到 外面 来
谢谢	感谢 的 表示感谢 尤指 对 接受 别人 给予 的 或 提供 的 恩惠 说些 感激 的话
决定	做出 主张
制作	指 写作
浏览	粗略地 看一遍 一作 刘览
完成	事情 按 预定 目标 做成
一点	汉字 部首
帮助	以 出钱出力 或出 主意 的 方式 相助 别人
增加	在 原来 的 基础 上 添加 在 这 多年 中 他 的 财富 增加 了 亦 何所 增加 唐 柳宗元 柳 河东 集
应用	适用 需要 以供 使用
计划	办事 前所 拟定 的 方案
拥有	占有 持有
参加	加入 某种 组织 或 活动
报告	向 上级 或 群众 就 调查 观察 的 结果 提出 详细 书面材料 或作 口头 叙述
注意	重视 关注
建立	开始 成立 或 产生
授权	委托 某人 或 某 机构 代行 权力
设置	放置 装置
获得	得到 取得 捕得
收藏	收集 保藏
才能	才智 和 能力
利用	利于 发挥 效用
保护	爱护 使 免受 可能 遇到 的 伤害 破坏 或 有害 的 影响
保证	担保 负责 做到
建议	向 有关 方面 提出 自己 的 主张
健康	人 的 一切 生理 机能 正常 没有 疾病 或 缺陷
作用	对人 或事物 产生 影响
交流	彼此间 把 自己 有 的 提供 给 对方 相互 沟通
代表	代替 个人 或 集体 发表意见 或 担任 工作 的 人
领导	带领 引上 主管 或 指导
安装	按照 一定 的 程序 规格 把 机械 或 器材 固定 在 一定 的 位置 上
采用	采纳 应用
存在	事物 持续 地 占据 着 时间 和 空间 实际上 有 还 没有 消失
查询	查考 询问
培训	培养 和 训练 使 体力 和 智力 得到 发展
编辑	在 出版部门 专门 处理 稿件 的 人
努力	尽量 将 力量 使 出来
了解	知道 得 清楚
供应	为 提供 商品 或 食物
教学	教书
达到	实现
实施	实际 施行
看看	查看 细看 检查
产生	从 已有 的 事物 中 形成 新 事物
接受	承受 接受 演说 的 邀请
快乐	欢乐 指 感到高兴 或 满意
引用	说话 或 写文章 时用 别人 作品 中 的 词句
左右	左和右 两 方面 主席台 左右 红旗 迎风 飘扬
过去	名 时间 词 现在 以前 的 时期 区别 于 现在 将来
娱乐	欢娱 快乐
分类	按照 种类 等级 或 性质 分别 归类
执行	贯彻 施行 实际 履行
调查	进行 了解 考查
咨询	征求意见 多指 行政当局 向 顾问 之类 的 人员 或 特设 的 机关 征求意见
建筑	指造 房子 修路 架桥 等
哈哈	动 用于 打哈哈 指 开玩笑 凑趣
访问	拜访 有 目的地 探望
记录	把 听到 的话 或 发生 的 事 写 下来
通知	把 该 办 或 该 知道 的 事情 告诉 人家
负责	担负 责任
申请	向 上级 或 有关 部门 申述 理由 请求 批准
保持	维持 某种 状态 使 不 消失 或 减弱
购买	买下
综合	把 分析 过 的 对象 或 现象 的 各个 部分 各 属性 联合 成 一个 统一 的 整体
增长	动 提高 增加
调整	重新 调配 整顿 使 适应 新 的 情况 和 要求
关注	关心 重视
造成	招致 或 引起
改变	事物 变得 和 原来 不 一样
加强	增强 使 变得 更强 和 更 有效
连接	相连 邻接 一座 连接 这个 城市 的 两 部分 的 桥
提出	揭示 提请 考虑 讨论 接受 或 采纳
传真	指 通过 有线电 或 无线电 装置 把 照片 图表 书信 文件 等 的 真迹 传送 到 远方
表现	表示 出来 显现出来
改革	改掉 旧 的 不合理 的 部分 使 更 合理 完善
移动	改换 原来 的 位置
说道	说 小说 中多 用来 直接 引进 人物 说 的话
检查	查看 查考
测试	测定 检查 试验
编号	给 顺序号 作为 一种 识别 的 方法
上市	指 货物 开始 在 市场 上 出售 西红柿 大量 上市
下来	动由 高处 到 低 处来
离开	离去 走开
登陆	渡过 海洋 或 江河 登上 陆地
删除	删去 删除 重复 的 部分
添加	增加
开展	从小 向 大 发展 使 展开
治疗	医治 疗养
超过	超越 别人
认识	确定 某物
形成	通过 发展 变化 而 成为 某种事物 或 出现 某种 情况
讨论	就 某事 相互 表明 见解 或 论证
取得	召唤 到
提示	给 演出 或 背诵 者 提醒 忘记 了 的 台词 或 内容 以 暗示 或 说出 已 忘记 的 或 未学 完善 的 下文 相助
创新	创造 新 的 革新
统计	  大量 数据 的 收集 分析 解释 和 表述 人口统计
方便	婉辞 大小便
制造	把 原材料 加工 成 适用 的 产品
参与	亦 作 参预 亦作 参豫 预闻 而 参议 其事 介入 参加
代理	短时间 代人 担任 职务
确定	明确 肯定
维护	以 说话 或 行动 保护
相信	认为 正确 确实 而 不 怀疑
过来	动 从 另 一个 地点 向 说话 人 或 叙述 的 对象 这边 来
修改	改动 删节 或 增添 改正 纠正
引起	某种事物 使 另 一 事物 出现
贡献	进奉 或 赠与 方今 匈奴 鄯善 哀牢 贡献 牛马 论衡
发行	批发
面对	指 面对面 或 仿佛 面对面 含有 决心 和 坚毅 或 对 一个 人 处境 的 真实 评价
告诉	在 刑事诉讼 中 被害人 或 其他 法定代理 人向 法院 提起 诉讼
考虑	思考问题 以便 做出 决定
宣传	向 人 讲解 说明 进行 教育 传播 宣扬
来到	从 一处 移动 到 某 一 目的地
报道	通过 报刊 广播电视 等 向 公众 报告 新闻
导致	使 产生 促成
播放	通过 广播 或 电视 放送 音响 或 影像
成立	组织 机构 等 开始 建立
输入	从 外部 送到 内部
收入	指收进 的 钱财
竞争	为了 己方 的 利益 而 跟 人 争胜
转载	刊登 别的 报刊 上 发表 过 的 文章
行动	走动 行走
安排	安置 处理
稳定	稳固 安定
看见	动义 同 看见 à 
坚持	坚决 保持 住 或 进行 下去
回来	动从 别处 到 原来 的 地方 来
丰富	种类 多 数量 大
规划	筹画 计划 尤指 比较 全面 的 长远 的 发展 计划
享受	在 心里 上 或 生活 上 得到 满足要求 和 愿望 得以 实现
好像	有些 像 仿佛   像
出口	～～ 表示 惊怪 如 ～～ 怪事
开放	花蕾 张开
理论	在 某 一 活动 领域 如 医学 或 音乐 中 联系实际 推演出来 的 概念 或 原理
统一	使成 一体
评价	评估 价值
招聘	用 公告 的 方式 让 人 应聘
分别	离别 分别 了 不到 一年 又 见面 了
举行	进行 某事
参考	查阅 利用 有关 资料 帮助 学习 研究 或 了解 情况
攻击	发起 或 发动 进攻
说话	用 语言表达 意思 发表 见解
相当	两 方面 差不多 配得 上 或 能够 相抵
结合	彼此 紧密联系
属于	归于 某一方面 为 某一方面 所有
加工	通过 特殊 处理 使 原材料 半成品 变得 合用 或 达到 某种 要求
明白	容易 理解 清楚
分享	与 他人 分着 享受 使用 行使
营销	经营 销售 ～ 观念 ｜～ 人员
启动	发动 开动
联盟	两个 或 两个 以上 的 独立 的 国家 或 民族 为了 互相 保卫 通过 正式 协定 条约 或 合同 建立 的 集团
指导	指示 教导 指点 引导
下去	动由 高处 到 低处 去
理解	据理 了解
消费	消磨 浪费
等等	表示 列举 未尽
声明	公开 表态 或 说明
遇到	犹 碰到
发挥	表现 出 内在 的 能力
欣赏	享受 美好 的 事物 领略 其中 的 情趣 音乐 ~｜~ 雪景 认为 好 喜欢 他 很 ~ 这个 建筑 的 独特 风格
满足	对 已 得到 的 感到 足够 了
解释	分析 说明
减少	去掉 一部分
发出	使 产生 声音
监督	察看 并 加以 管理
发送	把 无线电 信号 发射 出去
训练	教练 操练 兵士 教育学 名词 与 教学 意义 相近 训练 的 目的 是 使 受训者 获得 一项 行为 方式 或 技能
令人	使人
配置	作战 时 根据 任务 敌情 地形 将 兵力 兵器 布置 在 适当 的 位置
从事	干 某项 事业 他 已经 从事贸易 工作 多年
公布	公开 发表
存款	把 钱 存在 银行信用 合作社 里 也 指 存入 银行信用 合作社 里 的 钱
经历	亲身 见 过 做 过 或 遭受 过 他 一生 ~ 过 两次 世界大战
充满	形容 极多 到处 都 是
采取	采纳 听取 选取 实施 采摘 收取
促进	推动 使 向前 发展
培养	以 适宜 的 条件 促使 其 发生 成长 和 繁殖
毕业	学生 在 学校 或 训练班 修业期满 达到 规定 要求 结束 在校 学习 他 今年 毕业
出去	动从 里面 到 外面 去
失去	原有 的 不再 具有
观看	做 观众
整理	整顿 使 有条理 有 秩序 收拾
保密	保守 事物 的 秘密 不使 泄漏
不管	不顾 不 被 相反 的 力量 阻塞 或 阻止 无视 不利 的 结果
出版	把 书刊 图画 等 编印 出来
明确	清晰 明白
协议	共同 计议 协商
同意	同心 一心
清除	全部 去掉 扫除 干净
推广	推衍 扩大
投入	置身其中 放进去
返回	回到 一个 地方 或 状况 或 从 一个 地方 或 状况 回来 的 行动
集中	把 分散 人物 或事 集合 在 一起
留下	谓 把 东西 搁下 宋   无名氏 张协 状元 戏文 第八 出 你 要 好 时 留下 金珠 买路 我 便 饶 你 去 水浒传 第四 三回 你 留下 买路钱 并 包裹 便 饶 了 你 性命
反应	化学变化
流行	广泛传播 盛行
突破	打开 缺口
等待	不 行动 直到 所 期望 的 人 或 事 出现
掌握	熟知 并能 运用
担心	心中 有 顾虑 不 放心
贷款	银行 或 其他 信用 机构 向 借款人 所作 的 借款 须 在 一定 期限内 归还 并 支付 利息
限制	不让 超过 的 界限
包装	把 东西 打捆 成包 或 装入 箱 等 容器 的 动作 或 过程
升级	升到 比 原来 高 的 等级 或 班级
无关	不 牵涉 无 牵连 没有 关系
感谢	对 接受 别人 给予 的 或 提供 的 方便 恩惠 用 言行 表示 谢意
公开	将 事情 的 内容 暴露 于 大众
认证	有 职权 的 公务员 承认 某 事实 的 存在 或 某 文件 的 真确 而 证明 它
组成	组合而成
医疗	疾病 的 治疗
依然	照 往常 依旧
联合	结合 在 一起 的 共同 的
出售	卖出去
展示	摆出来 让 人 看
针对	专有 所指
符合	与 存在 的 式样 形式 或 标准 一致
所谓	所说 的
制定	定 章程 计划 法规 等
实践	指 改造社会 和 自然 的 有意识 的 活动
关闭	合拢 关闭 门窗 关闭 工厂 的 大门
提升	提拔 提高 职位 等级 等
进口	从 别的 国度 地区 购进 商品
忘记	不 记得 过去 的 事 没有 记住 应该 记住 的
记得	想得起来 没有 忘记
指出	提出 意见
承担	负担 或 担当
结婚	男女 通过 合法 手续 结为 夫妻 她 年纪 很大 了 才 结婚
计算	根据 已知 量算出 未知量 运算
保障	保护 权利 生命财产 等 使 不受 侵害
不足	不 充足 不够 满足 不了 需要
报价	提出 商品 股票 或 债券 的 当前 价格 的 行为 为 商品 股票 或 债券 给出 当前 的 出价 和 要价 的 行为 尤指 证券 和 商品 的 当前 出价 和 要价 或 时价 的 提出 或 公布 亦 指 这样 提出 或 公布 的 出价 要价 或 价格
实行	实际 施行
采购	大量 选购
成人	达到 完全 发育 尤其 是 在 身材 体力 或 智力 方面 的 人
组合	几个 独立 部分 组成 的 整体
值得	í é 的 又 音义 同 值得 í é
请问	敬辞 表示 请教 询问
降低	下降 减少
适合	符合 合宜
创建	首先 建立
装修	房屋 主体 结构 完成 后 的 内部 设施 安装 及 墙面 作业 房屋 交付使用 后 的 进一步 装璜 美化
清楚	清晰 明白 有条理
增强	增加 效能 强度
打造	制造
避免	使 不 发生
创业	亦 作业 开创 基业
报名	报名 àí  报告 自己 的 姓名 报名 àí  投考 或 应征 时 填写 姓名 籍贯 年龄 等 的 一种 手续 报名单
检测	检查 并 进行 测试
持续	无 间隔 连续不断
成长	长到 成熟 阶段
教授	高等教育 机构 的 教师 的 最高级 学衔
通信	相互之间 交换 信件 用 书信 反映 情况
相对	面对面 相向
收费	收取 费用 亦 指 收取 的 费用
消失	事物   逐渐 减少 以至 没有 或 人 或事物 由近及远 逐渐 到 看不见 不复存在
办理	经办 处理
意识	名人 的 头脑 对于 客观 物质 世界 的 反映 是 感觉 思维 等 各种 心理过程 的 总和
支付	付出 款项
不如	表示 前面 提到 的 人 或事物 比不上 后面 所说 的
确保	切实 保持 或 保证
重视	认为 很 重要 而 认真对待
召开	召集 开会
打印	刻 蜡版 和 油印
严格	遵守 或 执行 规定 规则 十分 认真 不 偏离 原则 不容 马虎
位于	占据 某个 相对 地点 或 位置
命令	由 上级 向 下级 发布 的 权威性 的 指示
拍摄	拍照 用 摄影机 把 人物 的 形像 照下来
反映	反照 比喻 表现 出 客观事物 的 本质
破坏	摧毁 毁坏
投票	选举 或 表决 时 把 表示 自己 意向 的 票 投入 票箱
伤害	使 受伤
紧张	精神 处于 高度 准备 状态
办公	办理 公务 处理 公事
感受	受到感染 生理学 上 指 由 感受器 接受 刺激 并 将 其 转化 为 神经 冲动
劳动	人类 创造 物质 或 精神财富 的 活动 体力 ～| 脑力 ～
登记	载入 正式 记录
购物	购买 物品
提醒	使 唤起 忘掉 的 事 或 很 难 再 想起 的 事 有时 是 通过 告诫 的 方法 引起 的 从 旁 指点 引起 注意
痛苦	身体 或 精神 感到 非常 难受 ~ 的 生活 ｜ 得 了 这种 病 非常 ~
赚钱	聚敛 财富 挣钱 盈利
包含	里边 含有
开心	心情愉快 舒畅
微笑	略有 笑容
挑战	激使 敌方 出战 左传 宣公 十二年 赵旃   求卿 未得且 怒 於 失   楚   之致 师者 请 挑战 弗许 东周 列国志 第四 八回 越椒   连日 挑战 郑   兵不出
保留	保存 不 改变 他 还 保留 着 当年 的 朝气
推进	推动 前进
复制	仿原 样品 制造
学会	研究 某一 学科 的 人 组成 的 学术团体
吸引	引导 别的 物体 力量 等到 自己 方面 来 也 指 引起 别人 的 注意
显得	表现 出 某种 情形 元   胡祗 y 快活 三过 朝 天子 赏春曲 梨花 白雪 飘杏G 紫霞消 柳丝 舞困 小蛮 腰 显得 东风 恶 水浒传 第四十回 知府 道 通判 如不信 时 就 教 观看 家书 显得 下官 不谬 二十年 目睹 之 怪现状 第八 二回 他 剃光 了 头 打 了 一条 油 辫子 越 显得 光华夺目 ＜ 艾青 诗选 ＞ 自序 周恩来   同志 从 浓荫 覆盖 的 高高的 石阶 上 健步 下来 穿 一身 浅 灰色 的 洋布 干部 服 显得 非常 整洁
聊天	以 轻松 随便 的 方式 谈话 不拘 礼仪 地不受 拘束 地 谈话
举办	开办 举办 训练班
扩大	使 范围 规模 等 增大
给予	使 别人 得到 给
疯狂	比喻 猖狂 而 凶狠
转换	改变 改换
主管	主持 管理
下降	向 低处 移动 降下
熟悉	ú ī 的 又 音义 同 熟悉 ú ī
关心	留意 注意
维修	维护 保养 修理
使得	能用 可以
运用	使用 利用 指 把 某种 东西 用于 预期 适合 的 某 一 目的 或 某人
损失	损毁 丧失
就业	得到 工作 机会 参加 工作
体现	某种 性质 或 现象 通过 某一 事物 具体表现 出来
加快	运动 或 进展 的 速率 的 增加
总结	把 一定 阶段 内 的 有关 情况 分析 研究 做出 有 指导性 的 结论 总和 各 方面 的 情况
高兴	愉快 而 兴奋
以为	认为
观察	细察 事物 的 现象 动向
驱动	用 动力 推动 带动 发动
侵犯	侵凌 触犯
突出	隆起 凸出
表明	表示 清楚
刺激	外界 事物 作用 于 生物体 使 事物 起 积极 变化
想法	动 设法 想 办法
接着	用 手接
强调	特别 着重 或 着重 提出
愿意	à ì 的 又 音义 同 愿意 à ì
发言	发表意见 多指 在 会上
保存	继续 存在 不受 损失
思考	思索 考虑
满意	意愿 得到 满足 符合 心愿
批准	上级 对 下级 的 意见建议 或 请求 表示同意
进来	动从 外面 到 里面 来
装饰	指 一般 人 日常生活 中 的 化妆 打扮
收集	使 聚集 在 一起
落实	使 计划 措施 政策 等 得以 实现
导演	监督 演出 如 舞台 银幕 或 电台 转播 并 负责 指导 动作 灯光 音乐 排练 在 总体 上 使 作者 的 观念 实体化 的 人
深入	研究 思考 深刻 透彻
禁止	不 准许 不许 可
实验	设计 来 检验 一个 理论 或 证实 一种 假设 而 进行 的 一系列 操作 或 活动
施工	按 设计 要求 建筑
相比	互相 考校 比较
奇怪	稀奇 特异
展开	展成 级数
上路	起程 动身
尊重	敬重 重视
鼓励	鼓动 激励 勉人 向上
仿佛	差不多 单独 作 谓语 前面 可加 相 用于 书面 两个 孩子 年纪 相 仿佛
宣布	公之于众
接触	碰上 挨上
回去	动从 别处 到 原来 的 地方 去
加盟	谓 参加 某一 团体  组织 鲁迅 且 介亭 杂文 关于 中国 的 两三件 事 四五年 前 我 曾经 加盟 于 一个 要求 自由 的 团体
求购	谓 悬赏 缉捕
估计	对 事物 做 大致 的 推断
预测	预先 测定 或 推测
环保	对 环境 进行 保护
摄影	拍电影
处于	居于 某种 地位 或 状态
指定	指明 确定
改善	使 原来 的 状况 变得 好些
设定	陈设 固定不动
无奈	没有 别的 办法
通讯	利用 电讯 设备 传送 消息 或 音讯 有时 指 来回 地 传送
麻烦	烦杂 琐碎 费事
沟通	本指 开沟 以使 两水 相通 后 用以 泛指 使 两方 相通 连 也 指 疏通 彼此 的 意见
允许	答应 同意
确认	明确 承认
高考	指 高等学校 的 招生 考试
放心	心绪 安定 没有 忧虑 和 牵挂
运输	用 车船 飞机 等 交通工具 把 旅客 货物 等 从 一个 地方 运到 另 一个 地方
表演	在 戏剧 舞蹈 杂技 等 演出 中 把 其中 的 各个 细节 或 人物 特性 表现 出来
战斗	敌对 双方 进行 武装冲突 作战
光临	敬称 他人 的 来访
采访	采集 素材 调查 访问
停止	停下来 不再 进行
面临	面对
固定	使 不 改变 不 移动
推动	使 事物 前进 是 工作 展开 总结经验 ~ 工作
批发	商品 成批出售
感动	受 外界 事物 的 影响 而 激动
具备	具有 拥有 有
适应	适合 于
进去	动用 在 动词 后 表示 到 里面 去
出生	胎儿 生 下来
防止	事先 行动 或 做好 准备 以 阻止 某事 的 发生 或 可能 发生 如 灾难 或 某事 的 成功 如 计划
缺乏	不足 缺少
传播	传送 或 散布
输出	从 内部 送到 外部
上涨	水位 上升
承诺	应承 允诺
招生	征招 新生
上升	指 位置 等级 程度 数量 等 由 低 向 高 移动 升高
打击	攻击 使受 挫折
创作	创造 文学艺术 作品
构成	凑成 组成 造成
透露	透漏 泄漏 消息
录入	把 文字 等 输入 到 电子计算机 里 ～ 员 ｜ 平均 每分钟 ～ 一百个 汉字
收购	从 各处 购入
帮忙	帮助 别人 做事 或 解决困难
转让	把 自己 的 东西 或 合法利益 或 权利 让给 他人
空调	动从 空中 调动
遵守	依照 规定 做 不 违背
定位	确定 方位
预计	事先 进行 估计 或 推测
反对	不 赞同
提交	提出 征求 决策
吃饭	维持 生活
在于	正是 就是 他们 的 错误 就 在于 轻敌
犯罪	做出 犯法 的 应受 刑法 处罚 的 事
生存	保存 生命 活在 世上
协调	和谐一致 配合 得当
涉及	牵涉到 作业 涉及 到 他人
隐藏	隐蔽 躲藏 不让 别人 发现
判断	估计 如 品质 行为 或 人 的 程度 力量 价值 或 性格
查找	彻底 考查 或 搜寻
改造	修改 或 变更 原 事物 使 适合 需要
美容	使 容貌 美丽 美化 容貌
赶紧	抓紧 时机 从速 进行
听说	听人 所说
进步	向上 或 向前 发展
引导	带领 使 跟随 引导 我们 通过 城市
补充	进一步 充实
打算	ǎ à 的 又 音义 同 打算 ǎ à
导航	导引 飞机 或 轮船 沿 一定 航线 向 一定 目的地 航行
取消	使 原有 的 制度 规章 资格 权利 等 失去 效力
矛盾	矛和盾 比喻 言行 自相 抵触
兴奋	奋起 激动
胜利	战胜 对方
付款	作为 对 货物 或 服务 的 报酬 而 支付 款项
接近	离得 近 靠近 我们 接近 那个 城市 了 一次 接近 于 以 零为 限度 的 误差
研发	研制开发 ～ 新药 ｜ 血液 代用品 ～ 成功
身后	过世 之后
刷新	刷洗 之后 使之变 新 比喻 突破 旧 的 而 创造 出新 的
反正	敌方 的 军队 或 人员 投到 自己 一方
模拟	模仿 仿效
求助	请求 帮助
举报	上报 清   黄六 鸿福 惠 全书 教养 礼耆 德择 本乡 年 八十 以上 素有 德行 从公 确实 举报
上去	动由 低处 向 高处 去
分配	按 比例 分发 尤指 按 比例 分 发给 一个 集团 的 成员
交换	彼此 把 自己 的 东西 给 对方 互换
翻译	用 一种 语言文字 来 表达 另 一种 语言文字
把握	用手 握住
投诉	投状 诉告
想象	见 想像
评估	评价 估量
审核	审查 核定
尝试	试一试 试验
答应	出声 回答
联想	因一 事物 而 想起 与 之 有关 事物 的 思想 活动
邀请	请人 出席 或 参加
设立	成立 建立
随便	不加 限制 不受 拘束
威胁	用 武力 逼迫 恫吓 使人 屈服 ~ 利诱
提前	提早 使 提早 发生
存储	把   信息   记录 在 电子设备 计算机 内 需要 时 可 将 资料 从中 取出
到达	指到 了 某 一 地点 或 阶段
配套	把 多种 相关 事物 组合 在 一起 成为 一个 整体
转移	从 一地 转往 另 一地
招商	招揽 商户
演出	把 戏曲 舞蹈 曲艺 杂技 等 在 观众 面前 表演
违法	违背 法律 法令
承认	对 既成 的 事实 表示 认可
差不多	相差不多 几乎 等于
害怕	面临 险境 而 心中 恐惧 惊慌
上来	动 开始 起头
看出	了解 明白 看 出来 觉察 发现 意识 到
看起来	显而易见
点头	快速 地 向前 低头 作为   同意 致意 或 命令 等 的   表示 而 向前 低头
受伤	受到 伤害
不禁	不 禁止 许可
便宜	便利 方便 合适
区别	区分 辨别
检验	检查 并 验证
策划	设计规划 密谋 计划 也 作 策画
走向	朝着 一个 方向 目的 行进 或 发展
精选	精心 挑选
练习	为了 获得 熟练 技巧 而 经常 进行 某种 动作
预防	预先 做好 防备
维持	保持 使 继续 存在
违反	不 符合 不 遵守
激动	由于 受到 刺激 而 感情 冲动
出租	收取 一定 的 租金 供 别人 定时 使用 某物
自主	自己 作主 不受 他人 支配
监控	监测 并 进行 控制
担任	担当 某种 职务 工作
幻想	虚 而 不实 的 思想
不对	有 误差 或 错误 的
装置	机器 仪器 和 设备 中 结构复杂 并 具有 某种 独立 功用 的 物件
转身	转过 身子 看 后面 或 侧面 的 东西 转过身 来
造型	塑造 立体 空间 构型
将来	未来 现在 以后 的 时间 少年人 常思 将来 清 梁启超 饮冰 室 合集 惟思 将来 据前 事 推 将来 制出 将来 在 可以 预见 的 将来
贯彻	彻底 实现 或 体现
强化	增强 加强
平衡	衡器 两端 承受 的 重量 相等
探索	多方 寻求 答案 研究
改进	改变 原有 状况 使 得到 提高
标志	表明 特征 用以 识别 的 记号
传输	传递 输送 能量 信息 等
获取	获得 谋取
可怜	值得 怜悯
连载	分 多次 连续 在 报刊 上 登载 一部 作品
前往	离开 此地 向 走 去
恋爱	指 男女 依恋 相爱
付出	交出
见面	古文 同 腼 害羞 不 自然
评分	评定 分数
讲话	指 正式 的 演说
许可	答应 允许
加速	增加 速度
思维	哲在 表象 概念 的 基础 上 进行 分析 综合 判断 推理 等 认识 活动 的 过程 思维 是 人类 特有 的 一种 精神 活动
考核	考试 考定 核查
引进	带领 入内
提到	提及 说 及 说 到 尤指 简短地
照顾	动 考虑 到 注意 到
生气	活力 生命力
意味着	意指
检索	检查 索取 所 需要 的 文字 或 资料
感染	病原 微生物 以及 寄生虫 等 侵入 机体 并 生长 繁殖 引起 的 病理 反应 及 对 机体 造成 的 损害
出台	演员 登台 演出
填写	按照 一定 要求 在 需 填 注处 写字 或 填 数字
沉默	一言不发 的
退出	离开 所 参与 的 某事 或 某种 活动
广播	利用 无线电 或 电视信号 对 大众传播
主演	扮演 主角
点评	阅读文章 时 加以 圈点 并 写 上 评语
印刷	把 文字 图画 等 制成 版涂 上 油墨 印在 纸张 或 其他 材料 上
如同	好像 类似
到来	按时 接近 或 即将 临近
批评	评论 评判
浪费	不 充分利用 不 珍惜 不必要 地 废弃
考察	实地 观察 调查
依旧	依然 像 从前 一样
注明	注解 说明
促销	企业 为 提高 其 商品 在 市场 上 的 占有率 而 进行 的 各种 推销 活动 如 扩大 广告宣传 派出 销售 人员 直接 向 中间商 或 消费者 兜售 等
失望	丧失 信心 希望 没能 实现 他们 威胁 他 搜索 他 结果 却 连 一个 铜元 也 没有 失望 之余 就 抢走了 他 的 怀表 和 钢笔 同志 的 信任
审批	对 下级 呈报 上级 的 公文 进行 审查 批示
集成	总体 尤指 知识 的 或 证据 的
污染	使 沾 上 脏物 或 有害物质
体会	体验 领会
纪念	记载 ～ 年 ～ 元 ～ 行 í～ 实 ～ 念 ～ 传 à 体 中国 传统 史书 的 一种 体裁 以 人物传记 为 中心 叙述 史实 纪是 帝王 本纪 传是 其他 人物 的 列传 ～ 事 本末 体 中国 传统 史书 的 一种 体裁 以 重要 事件 为 纲 将 一段 历史 完整 地 记载下来
长大	动 生长 壮大
分为	判断 断定
调节	在 数量 程度 规模 等 方面 进行 调整 使 符合标准
回应	回答 应声 对 反应
开口	同 Z
委托	托付给 别的 人 或 机构 办理
证实	证明 其 确实
再说	进 一层
穿着	把 衣服 鞋袜 等 物套 在 身上
吸收	物体 把 外界 物质 吸到 内部
承受	接受 承担
成就	业绩 事业 上 优良 的 成效
执法	执掌 法律 行使 法律 权力
上班	在 规定 的 的 时间 到 工作 地点 工作
面议	面对面 地 直接 商议
压缩	加以 压力 以 减小 体积 大小 持续时间 密度 和 浓度 等
主持	负责 掌握 或 处理
提问	提出 问题
曝光	使 感光纸 或 摄影 胶片 感光
惊讶	惊异 惊奇
现代化	使 具有 现代 先进 科技 水平
回头	把头 转向 后方
辛苦	原指 味道 辛辣 而苦 比喻 艰难困苦
陷入	谓 落 在 不利 的 境地 后汉书 寒朗 传是 时   显宗   怒 甚吏 皆 惶恐 诸所连 及率 一切 陷入 无敢 以情 恕者 李固文 月食 他 没有 必要 陷入 这样 的 困境
居住	较长 时期 住 在 某个 地方 或 较 长期 地 住在一起
生成	产生 形成
郁闷	愁眉不展 的 性质 或 状态
默认	虽未 言明 心里 却 承认
鉴定	鉴别 审定 事物 的 真伪 优劣
进攻	接近 敌人 并 主动攻击
团结	唐宋时 地方 民兵 丁壮 组织 亦 指 该类 组织 的 士兵
领先	共同前进 过程 中 走 在 最 前面 在 某一方面 居 第一位 或 在 最 前面
出席	到 会
引发	指 出殡
争取	力求 获得 或 实现
后悔	为了 过去 的 作为 或 为了 没有 做到 的 事 而 感到 懊悔
请求	提出 要求 希望 得到 满足
喜爱	指对 某人 或事物 有 好感 或者 产生 兴趣
注重	重视
零售	直接 售给 消费者
循环	以 环形 回路 或 轨道 运行 沿 曲折 的 路线 运行 特指 运行 一周 而 回到 原处
缓缓	犹 徐徐 缓慢 貌
解放	解除 束缚 得到 自由 或 发展
不详	不 详细 不 完善
治理	整治 调理
加油	添加 燃料油 或 加入 润滑油
监管	监视 看管 罪犯
赢得	获得
高达	谓 才 高 而 通达
备案	向 主管机关 报告 事由 登记 备查
辅助	从 旁 帮助 协助
予以	给 以
减肥	减轻 肥胖 程度
前来	到 这里 来 向 这个 方向 来 隋书 裴矩 传 天子 大出 珍物 今 在   马邑 欲 其蕃 内多作 交关 若 前来 者 即 得 好 物明   唐顺之 海贼 分道 侵突 疏 十九日 辰时 大伙   倭   贼 约 二千 N 突n 前来
指挥	发令 调度
搜集	搜寻 聚集
交友	朋友 商君书 禁使 故至治 夫妻 交友 不能 相为 弃 恶盖 非 而 不害 于 亲民人 不能 相为 隐 隋书 元亨 传亨   年 十二 魏恭帝   在 储宫 引为 交友 宋   张世南 游宦 纪闻 卷八 黄公字   子厚 富沙   浦城   人 与   朱文公   为 交友
交给	给与 付给
对比	两种 事物 或 一 事物 的 两个 方面   相对 比较
纺织	纺纱 与 织布
对待	以 特定 方式 或 某种 态度 看待 人 或物
想想	思考 一下
爆炸	物体 体积 急剧 膨大 炸裂 使 周围 气压 发生 强烈 变化 并 产生 巨大 声响 的 现象
告知	说 给 某人 让 他 知道
询问	打听 发问
预期	含义 是 对 未来 情况 的 估计
消除	使 不 存在 除去
放下	放在 一边 或 放弃
请教	请求 指教
降价	降低 价格
同事	同事 óì  相与 共事 执掌 同一 事物 同事 者 曰 清方 苞 狱中 杂记 过去 我们 同事 多年 同事 óì  共事 的 人 后 指 在 同一 单位 工作 的 人 老同事
认定	认可 确定
含有	作为 的 容器
犹豫	犹移 迟疑不决
演唱	以唱 的 方式 表演 歌曲 戏曲 等
冲击	冲撞 碰击 多指 风威 水势 海浪 冲击 着 岩石
围绕	包围 环绕
不好意思	不美 不善
遗憾	遗恨 由 无法控制 的 或 无力 补救 的 情况 所 引起 的 后悔
上门	登门 到 人 家里 去
节省	把 可以 不 耗费 的 减省 下来
称为	叫做 商品 的 普通 销售价格 称为 市价
完了	了结 完结
冲突	冲杀 奔突
障碍	阻挡 前进 的 东西
记住	留在 记忆 中
对付	处理事务 办理
搭配	跟 主要 的 人 或事物 在 一起 做 陪衬
支撑	顶住 压力 使 不 倒塌
防治	译为 预防 和 治疗 或 预防 和 治理
不满	不 充满
警告	对 犯错误 者 的 一种 处分 他 受到 了 警告 处分
处罚	依据 法令 规章 加以 惩罚 即使 犯错误 或 犯罪 的 人 受到 政治 或 经济 上 的 损失 而 有所 警戒
反复	翻悔 变化无常
留学	到 外国 学习 或 研究
依靠	凭借
寻求	寻找 探求 追求
得知	从 知道
招标	包方 根据 各 承包 对象 提出 的 承包 方案 选择 最佳 承包者 的 过程
评级	根据 某种 调查表 所载 次目 逐项 检查 某人 在 这些 方面 的 表现 而 得出 的 对 这 人 的 特性 和 品质 如 兴趣 能力 态度 或 个性 所作 的 估计
协助	从 旁 帮助 辅助
懂得	谓 了解 其事 或 其意 儿女 英雄传 第十六回 邓九公   哈哈大笑 h 老弟 台 我h句 不怕 你 思量 的话 这个 事 可不是 你们 文字 班儿 懂得 的 二十年 目睹 之 怪现状 第二回 我 虽 不 懂得 风鉴 却是  v多 了 有点 看得出来 周而复 上海 的 早晨 第一部 二九 他 说完 了 暗暗 看 了   徐义德   一眼 那 意思 是 说 凡事 要 提高 一步 看用 旧 眼光 来 办厂 现在 是 吃不开 了 徐义德   懂得 他 眼光 的 意思
前进	上前 向前 行进
接收	接纳 收受
模糊	轮廓 模糊不清
签订	签署 契约 或 定单
联络	军队 各 部分 之间 建立 并 保持 相互 关系 以 保证 相互了解 各自 的 情况 采取 统一 的 行动
出手	卖出 货物 抛售 完毕
幸运	好运气
识别	辨认 辨别 区分 分辨
运营	车船 等   运行 和 营业
摇头	头 左右 摇动
听见	动 听到
渴望	迫切 地 希望 殷切 盼望
展现	展示 明显 地 表现 出
赠送	用 馈赠 送礼 的 方式 为   某人   提供 某些 东西
验证	检验 或 测验 精确性 或 准确性
司法	见 执法
诊断	诊视 而 判断 病情 及其 发展 情况
分手	分别 分开
透过	通过
修正	遵行 正道 亦 指 遵行 正道 的 人
预定	事前 规定 决定 或 约定
主办	主持 办理
订购	预先 约定 购买
下跌	水位 价格 等 下降 贬值 股市行情 下跌
修复	修整 使 恢复 原样
更换	调换 替换
分布	指在 一定 地区 或 区域 内 散布
负担	费用 开支
覆盖	遮盖 掩盖
危害	构成 伤害 或 损害
信任	相信 并 加以 任用 史记 蒙恬 列传 始皇   甚尊 宠   蒙氏 信任 贤之南史 荀伯玉 传高帝   重   伯玉   尽心 愈见 信任 使 掌军国 密事元   陈以 仁存 孝 打虎 楔子 唐僖宗   信任   田令孜   等 贪财 好贿 人民 失散 四野 |荒
扫描	通过 电子束 无线电波 等 的 左右 移动 在 屏幕 上 显示 出 画面 或 图形
惊喜	又惊又喜
达成	达到 一个 目的 或 实现 一个 目标 尤指 有意识 的 努力
超越	逾越 胜过
展览	展示 实物图片 以供 观览 欣赏
部署	处理 料理
恐惧	畏惧 害怕
动手	开始 去 做 某件事 情
烦恼	烦闷 苦恼
性爱	指 人类 两性 相爱 雌雄 性 之间 的 爱恋
赔偿	对 损失 损坏 或 伤害 的 补偿
释放	恢复 人身自由
讨厌	令人烦恼 惹人 心烦
总计	总括起来 计算
摘要	摘取 精要 摘要 引证
剩下	在 消耗 和 使用 后 作为 剩余 留下
流通	货币 或 其他 交换 手段 在 整个 团体 或 社会 内 从 人 到 人 的 传递
探讨	探索 研讨 探索 讲求
定价	规定 价格
扩展	向外 伸展 扩展 对外贸易 城市 边界 扩展 到 把 全县 都 包括 在内
上课	老师 在 学校 里 讲课 学生 听 老师 讲课
亮相	戏曲 演员 上下场 时 或 表演 舞蹈 时由动 的 身段 变为 短时 的 静止 的 姿势
自动化	最高级 的 机械化 和 电气化 机器设备 和 仪器 能 全部 自动 地 按规定 的 要求 和 既定 的 程序 进行 生产 人 只 需要 确定 控制 的 要求 和 程序 不用 直接 操作
评选	评比 并 推选
备份	方 虚设 以 充数
阻止	阻拦 制止
报警	报告 危急情况
燃烧	剧烈 氧化 消耗 燃料 并 发出 光热 和 气体
连锁	一环扣一环 连续不断
优先	放在 他人 或 他 事 之前 多指 在 待遇 上 占先
清洁	无 尘垢 的 干净 的
约定	商量 并 确定
审查	检查 分析 核对 有关 情况
录音	用 仪器 录制 音响 录成 的 音响
谈判	有关 方面 在 一起 相互 通报 或 协商 以便 对 某 重大 问题 找出 解决办法 或 通过 讨论 对 某事 取得 某种程度 的 一致 或 妥协 的 行为 或 过程
汇款	把款 汇出
生长	在 一定 的 生活 条件 下 生物体 体积 和 重量 逐渐 增加 由小到大 的 过程
辅导	帮助 和 指导
不一定	谓 不能 确定 或 不见得
履行	实行 职责
珍惜	珍视 爱惜
抬头	抬起 某人 的 头
传递	递过去 辗转 递送
锻炼	通过 军事训练 或 体育 活动 增强体质 每个 早上 进行 走路 上班 的 锻炼
带领	引导 领导 指挥
拍卖	商业 中 的 一种 买卖 方式 一般 由 出卖 者 把 现货 或 样品 陈列 出来 由 购买者 竞相 出价 争购 直到 无人 再 加价 时 就 拍板成交
加以	连词 表示 进一步 的 原因 或 条件
纪录	纪通 记指 做 记录 的 人纪 通记 官吏 有 功绩 或 犯有 罪过 记录在案 以为 其后 升迁 黜 罚 之 依据 旧唐书 突厥 传上默 啜功 合纪 h 以 劝 戎行 明   唐寅 与 文徵明 书为 国家 出 死命 使 功劳 可以 纪 h 明律 名 例律 职官 有犯 其犯 应该 笞 决罚 俸 收赎纪 h 者 不 在 奏请 之限 又   清   制 官吏 有 功绩 者 议 叙之法 一 曰 纪录 二 曰 加级 纪录 计以次 有 纪录 一次 二次 三次 之别级 一当 纪录 四次 纪通记 记载 事情 的 文字 唐   韩愈 进顺 宗皇帝 实录 表状 自 虽 二帝 三王 之盛 若 不 存纪 h 则 名氏 年代 不闻 於 兹 功德 事业 无可 称道 焉 宋   曾巩 请 访问 高骊 世次 或 来 使 未能 尽 对 即 I 以候 归 本国 讨寻纪 h 因向 后别 使 人 附来 沈从文 ＜ 沈从文 散文 选 ＞ 题记 至于 我 这 两本 习作 能 看做 探路 打前站 的 哨兵 纪录 对 家乡 同好 起点 参考 作用 就 足够 了 纪通记 记载下来 的 最高 成绩 魏巍 东方 第五部 第八章 他 竟然 创造 了 打死 五个 敌人 的 最高 纪录 秦牧 长街 灯语 中国 的 书龙 这些年来 美国   和   日本   的 最 畅销 的 文学 书 都 已经 达到 了 八百万 册 以上 的 纪录 纪通记 记录 用 文字 记载 汉   王充 论衡 超奇 古昔 之远 四方 辟匿 文墨 之士 难得 纪 h 魏书 序纪 淳朴 为俗 简易 为化 不为 文字 刻木纪 契 而已 世事 远近 人相 传授 如 史官 之纪 h 焉 新唐书 儒学 传上 朱子 奢帝 尝t 起居 纪 h 臧否 朕 欲 见 之 以知 得失 若何 清   周中孚 郑堂 札记 卷 一汉   兴大 中 大夫   陆贾   纪 h 时功 作楚汉 春秋
监测	监管 并 检测
进展	向前 发展 在 他 的 主管 下 城市 建设 进展 得 很 迅速
起身	动身 起程
用力	花费 精力 使劲
活跃	行动 活泼 而 积极
积累	积聚 起来 的 事物 多年 的 积累
应对	答对 采取措施 对策 以 应付 出现 的 情况
测量	用 仪器 测定 地形 物体 位置 或 温度 速度 功能 等 物理量
清理	彻底 整理 或 处理
审计	审查 核定 财政收支 预算 决算 等
在家	在 家里
发放	发给
自杀	自己 杀死 自己
好奇	流露 或 显示 出 好奇 的 尤指 对 他人 之事
损害	使 受伤害
不安	不 安宁 的
打破	物件 受到 突然 或 猛烈 的 一击 而 出现 缺口 或裂 为 碎片 或 几 部分
发动	使 开始
防御	防守 抵御
研制	研究 制造
回报	把 任务 使命 等 执行 情况 报告 上级
放松	控制 或 注意力 由紧 变松 而 松驰 松懈 或 轻松
分开	使 彼此 分离 相互 不 合在一起 或 离开
冒险	在 投机 赌博 或 其他 靠 运气 的 这 一类 事情 中 冒 失败 或 输掉 的 风险
决心	坚定不移 的 意志
申报	向 上级 或 有关 部门 提出 书面报告
反弹	压紧 的 弹簧 弹回 运动 的 物体 遇到 障碍物 后 向 相反 的 方向 弹回
理财	管理 财物
构建	建立 多 用于 抽象 事物 ～ 新 的 学科 体系
思念	想 考虑 动脑筋 ～ 想 ａ 客观存在 反映 在 人 的 意识 中 经过 思维 活动 而 产生 的 结果 ｂ 想法 念头 ｃ 思量 ～ 忖 ～ 索 ～ 维沉 ～ 寻 ～ 见异 ～ 迁
更改	变更 改动
期望	对人 或事物 的 未来 有所 等待 和 希望
伸手	伸出手
分离	从 混合物 中 隔离 出来
错过	丧失 时机
提起	谈到 说起
不幸	指 死亡
树立	建立
加密	把 一份 电报 译成 密电码
合成	由 部分 组成 整体
教练	从事 教练 工作 的 人
面试	当面 考试
复习	重复 学习 学过 的 东西 使 巩固
呈现	显现 展示 出 呈现 了 多姿 的 风彩
跟踪	紧紧 跟随 在 后面
袭击	乘其不备 偷偷地 进攻
当作	见 当做
收获	收取 成熟 的 农产品
转向	改变方向
讲述	把 事情 和 道理 讲 出来
扮演	演员 装扮成 戏中 某 一 角色 演出
解答	答复 说明
交往	互相 走动 拜访 来往
预订	事先 订约 购买 东西
合并	见 合并
选购	挑选 购买 商品
相似	相类 相像
编写	编排 书写
开启	启开 打开 如 一扇门 或 一只 盖子
缺少	短缺 缺乏 不足 不够 数量
完毕	完结 完 了
罢了	语气词 用 在 陈述句 的 末尾 有 仅此而已 的 意味 对 句子 的 意思 起 冲淡 的 作用 前面 常 跟 不过 无非 只是 等 词 呼应
冲动	神经 受到 刺激 引起 的 兴奋性 反应
无力	没有 力气
追究	追查 已往 的 事实 或 过失
收取	收留
得以	指借 某 事物 而 能 做 某事 能够 可以
营业	职业 工作
认可	承认 许可
开拓	采掘 前 修建 巷道 等 工序 的 总称
消耗	消散 损耗 今 多指 因 使用 或 受损 而 逐渐 减少
冷静	平心静气 毫无 偏见 地 分析 道理 而 不 感情用事
疑惑	迷惑 不 理解
沉重	沉重 儿名 责任 负担
点歌	指定 歌曲名 或 同时 指定 演唱者 听取 演唱 新民晚报 点歌 作为 一种 温馨 的 感情 传递 方式 正 走进 都市 的 千家万户
收录	编辑 采用
舒适	给人以 安乐 舒服 的 感觉
拓展	开拓 扩展 拓展 国际 市场
营造	制作 做
得意	满意 感到 满足 时 的 高兴 心情
混合	搀合 合在一起
爆发	有 火药 或 爆炸物 的 物件 因 爆炸 而 破裂 飞散
离婚	脱离 夫妻 婚姻关系
示范	做出 榜样 或 典范 供 人们 学习
回顾	回想 过去 思考 过去 发生 的 事件
试点	全面 开展 工作 前先 在 一处 或 几处 试做
牺牲	供 祭祀 用 的 纯色 全体 牲畜 供 盟誓 宴 享用 的 牲畜
作文	撰写 文章
旋转	绕 一个 轴 转动
合资	几个 方面 一起 投资   办 企业
累计	前 几个 与 后 几个 的 结合
试用	使 某人 受到 一段 时期 的 检验 或 试工 以便 能 确定 这人 是否 适合 于 做 某事
庆祝	为 共同 的 喜事 而 进行 某些 活动 表示 高兴 或 纪念
驾驶	操纵 车船 等 运载工具 行驶
勉强	能力 不足 而强 为 之
赶到	等到 到达 赶到 明儿个 可 就 误事 了 赶到 船一 靠近 岛屿 我 便 跨 上岸 走进 海 市里 去 海市
摆脱	冲破 束缚 和 障碍 而 获得 自由
汇报	综合 材料 向 上级 或 群众 报告
租赁	租借
爱好	也 说 爱好 儿指 感情 融洽 要 好
订阅	订购   报刊
严肃	令人敬畏
拼命	豁出 性命 去 干 某事
严禁	严格 禁止
发射	从 斜轨 发射器 或 其他 装置 放出 或 弹射 出 自动 推进 的 物体
改为	另制 重造
考验	考查 验证
落后	s不上 落 在 后头
成交	买卖双方 达成 一项 或 一笔 交易
持有	掌管 保有
感激	因为 别人 的 好意 或 帮助 而 对 他 有 好感
演示	有 实例 或 实际操作 显示 或 证明
激励	激发 勉励 使 振作
以免	用于 提起 下 半句话 表明 前 半句话 是 为了 使下 半句话 所说 的 情形 不至于 发生
送给	作为 无偿 物 给予
调研	调查 并 进行 研究
收拾	整理 布置 整顿
试图	打算
教训	指从 错误 或 挫折 中 得到 的 经验 水灾 的 教训
融合	熔成 或 如 熔化 那样 融成 一体
传送	把 一处 的 东西 送到 另 一处
不明	尚未 清楚 地 辨明 确定 或 明确 方位 的
增大	使 由 小 变大 加大
保养	保护 调养
挣扎	竭力 支撑 或 摆脱
难过	指 生活 困难 日子 不 容易 过
节能	在 能源 的 利用 上 节约 不 浪费
演绎	从 前提 必然 地 得出结论 的 推理 从 一些 假设 的 命题 出发 运用 逻辑 的 规则 导出 另 一 命题 的 过程
怀孕	卵子 受精 后 形成 活 的 合子 孕育 产生 子代 的 过程
发觉	开始 知道
解除	免除
看好	守护 照料 好
聚会	聚集 会合
入学	开始 小学 学习
补偿	在 某 方面 有所 亏失 而 在 另 方面 有所 获得 的 叫 补偿
带动	用 动力 使 相关 机件 运动
发起	倡议   做 某件事 情
变更	改变 更改
携带	随身带 着
盈利	众多 之利
热爱	形容 爱 的 程度 很深
健身	一种 体育项目 尤指 包括 徒手 或用 器械 的 体操 体操 可以 增强 力量 柔韧性 增加 耐力 提高 协调控制 身体 各 部分 的 能力
配备	指 供应 旅行 远征 考察 探险 或 特殊 场合 所 必备 的 各种 物品
凭借	依恃 用 的 手段
防范	戒备 防备
竞赛	比赛 争取 优胜
叫做	把 称为 把 命名 为
享有	在 社会 上 或 某个 领域 内 博得
不止	不 停止
奋斗	为了 达到 目的 克服困难 或 防止 邪恶 而作 的 极度 的 努力 或 尽力
放大	使 图像 声音 功能 等 变大
回收	从 矿石 废品 或 副产品 中 收取 有用 材料
打工	方 做工
忽视	不 重视
羡慕	爱慕 钦慕 希望 自己 也 有
实习	把 学到 的 东西 或 知识 拿到 实际 工作 中去 应用 以 提高 工作 能力
迎接	走向 前 接待
心想	思想感情
开车	驾驶 车辆
出国	到 外国 去
开机	开动机器
依赖	倚靠
出品	生产 制造 出产
验收	按照 一定 标准 进行 检验 而后 收下 或 认可
护理	守护 料理
调用	调度 使用
商量	交换意见
布置	根据 某种 需要 对 场所 活动 人员 等 做出 安排
战胜	在 战争 竞争 或 竞赛 中 取得胜利 或 取得成功
治愈	使 恢复健康
相处	共同 生活 相互 交往
便利	方便 的 适合 于 从容 完成 某种 动作 或 职能 的
应付	对人对事 采取 一定 措施 处理
过滤	通过 持殊 装置 将 流体 提纯 净化 的 过程
可谓	可以 说 是 可以 称为
发明	创造 出新 事物 或 新 方法
佩服	è ú 的 又 音义 同 佩服 è ú
普及	普遍 传播
搜寻	四处 搜索 寻找
震撼	指 心理 受到 强烈 冲击 憾动
舒服	身体状况 好
办事	处理 公务
率先	带头 首先
兼职	一人 同时 担任 两个 或 两个 以上 的 职务
融资	企业 双方 相互 融通 资金 的 信用 活动 具体表现 为 需要 融入 资金 的 一方 与 可融 出 资金 的 一方 通过 协议 进行 货币资金 的 转移 其 形式 有 货币资金 的 借贷 买卖 有价证券 预付定金 和 赊销 商品 等 有 直接 融资 和 间接 融资
减轻	降低 重量 负担 等
演讲	当众 阐述 解说
当成	当做
用人	选择 和 使用 人员
唱歌	以 抑扬 有 节奏 的 音调 发声
收回	指 取回 发出 借出 的 财物
主张	提倡 扶持 对 某种 行动 提出 见解
支援	支持 援助
健全	身体健康 而 无 缺陷
选举	选取 任用 贤才
得出	获得 达到
抑制	约束 压制
选用	挑选 或 应用 选择 使用
波动	波浪式 地 涨落 或 起伏 式 地 运动
记载	把 事情 记录下来
附加	额外 加上
节约	节省 励行 节约
支出	开销 支付 用于 军用飞机 的 支出
占据	用 强力 取得 保持
解析	剖析 深入分析
防守	守卫 把守
按摩	用手 或 器械 来回 摩擦 揉捏 或 敲打 身体 的 表面 部分 的 行为 用于 治疗 目的
组建	组织 并 建立
约会	ē ì 的 又 音义 同 约会 ē ì
担保	表示 负责 保证 做到 或 保证 不出 问题
指示	指明 显示
吃惊	受惊 使人 感到 惊讶
生育	生产 生养
颤抖	颤动 发抖
回归	发生 倒退 或 表现 倒退 常指 趋于 接近 或 退回 到 中间状态
忍受	勉强 承受
低头	垂下头
强制	用 某种 强迫 的 力量 或 行动 对付 阻力 或 惯性 以 压迫 驱动 达到 或 影响
质疑	提出 疑问请 人 解答
谈话	彼此 的 对 谈
通话	用 彼此 都 懂 的 语言 交谈
清洗	洗净 清洗 伤口
不解	不能 解开 不能 分开 楚辞 九章 哀 郢 心 \结而 不解 兮 思 蹇 产而 不释 汉   枚 乘 七发 楚苗   之 食安胡 之 之 不解 一 啜 而 散明   李贽 过 桃园 谒 三义 祠诗 谁 识   桃园   三 结义 黄金 不解 结 同心
指点	指示 点明
聚集	集合
尊敬	尊崇 敬重
变动	变化 更动
斗争	矛盾 双方 的 冲突 一方 力求 战胜 另一方
集合	分散 的 人 或事物 聚集 到 一起 使 聚集
报考	报名 投考
延长	扩展 长度 使 更长 延长 一条 道路
穿过	从 一个 地方 经过 另 一个 地方 到达 第三个 地方
绝望	断绝 希望 毫无希望
继承	按照 法律 或 遵照 遗嘱 接受 死者 的 财产 职务 头衔 地位 等
拥抱	搂抱 表示 亲爱
绿化	使 变为 绿色 广泛 种植 花草树木 使 环境优美 卫生 防止 水土流失
受理	接受 办理 接受 处理
欺骗	用 虚伪 的 言行 隐瞒 真相 使人 上当
开设	开办 设立
发给	指在 要求 投标 或 出价 之后 判给 或 分给
忽略	疏忽 不在意 没 注意 到
到位	到达 预定 位置
立法	国家 权力 机关 按照 规定 程序 制定 或 修改 法律
响应	指其 如 回响 的 应声
失踪	不见 踪迹 多指 人 的 下落不明
不容	不许 不让
道歉	为 不 适当 或有 危害 的 言行 承认 不是 承认 使人 委屈 或 对 人 无礼 同时 表示遗憾
修炼	道教 的 修道 炼气 炼丹 等 活动
无所谓	没关系 不在乎
开玩笑	戏弄 耍弄 说笑话 问题 已经 一团糟 公司 的 财经 变成 了 两年 一度 的 开玩笑 你 还有 工夫 跟 人 开玩笑
披露	揭示 其 隐蔽 或 隐私 表露 显露
违规	现在 多 用于 违反 合同规定
推行	推广 实行
扩张	扩大范围 势力 等
开业	开始 业务 活动 多指 企业 商店 诊所 等
脱离	离开 脱离 旧 家庭
防护	一种 防备 和 保护 的 方式 或 方法
激发	激动 奋发
远离	远远地 离开 三国   蜀   诸葛亮 前 出师表 臣 不胜 受恩 感激 今当 远离 临表 涕泣 不知所云 章炳麟 菌 说 吾 观六 波罗 密经言   忉利天   临命 终时 天女 眷属 皆 悉 远离 弃 之 如草
路过	途中 经过
对抗	双方 对立 相持不下
震惊	令人 震动 而 惊异
延伸	延长 扩大 宽度 大小 范围 延伸 一条 道路 把 铁路 延伸 到 另 一个 城市
来临	来到 到来
培育	培养 幼小 生物 使 其 发育 成长
赞同	赞许 认同
挑选	从 一些 人 或事物 中 选出 合乎 要求 的
度过	让 时间 在 工作 生活 娱乐 休息 中 消失
编码	把 设计 的 程序 以 某种 合适 的 语言 改编 成 表示 该 程序 的 一系列 准确 而 详尽 的 指令 之 一种 过程
消灭	消失 灭亡
保安	保护 地方 的 安宁
擅自	越权 自作主张
遇见	动 碰到
刊登	在 报刊 中 发表 每 一种 报纸 都 刊登 了 这条 报道 或 这个 故事
参赛	参加 比赛
武装	用 武器装备 军队
飞扬	飞舞 飘扬
开幕	表演 开始 时 拉开 舞台 前 的 幕 亦 指 开场
不及	不如 比不上 如 不及 几年 前
夸张	夸大 言过其实
飞翔	回旋 而 飞
协商	为了 取得 一致意见 而 共同 商量
监视	从 旁 监察 注视
犹如	好像
排列	置于 正确 方便 或 适宜 的 次序
警惕	对 可能 发生 的 危险 等 保持 警觉
纳入	归入 多 用于 抽象 事物
登场	谷物 收割 运到 场上
取代	推翻 他人 或 排斥 同类 以便 自己 顶替 其 位置
抱怨	à à 的 又 音义 同 抱怨 à à
通报	上级 机关 把 有关 情况 以 书面形式 通告 下级机关
象征	用 具体 事物 表现 某些 抽象 意义
退休	职工 因 年老 或 因公 致残 而 离开 工作岗位 按期 领取 生活费用
干扰	扰乱 打扰
入侵	以 征服 或 虏掠 为 目的 的 窜犯
丢失	失掉 遗失
签署	在 文件 条约 凭证 等 上 签字
言语	说 出来 的话 说 出来 的 一个 词
上演	指 戏剧 舞蹈 等 演出 放映
伴随	伴同 还有 列队 笨重 的 步伐 声 和 军刀 的 撞击声 伴随 着 乐曲 的 节奏 法国 都 德 柏林 之围
做事	担任 有 固定 的 职务 工作
做爱	在 性爱 活动 中 拥抱 亲吻 异性
直播	种子 不 经过 育苗 直接 播到 田地 里
感冒	伤风 由 病毒 混合 感染 或 变态反应 引起 的 上呼吸道 卡他性 疾病 表现 为 鼻塞 流涕 打喷嚏 咳嗽 咽部 不适 及 畏寒 低热 等 局部 和 全身 症状
储存	把 钱 或物 存放 起来 暂时 不用
等于	一样 没有 区别
获悉	得到 消息 知道 某种 情况
恭喜	套语 恭贺 别人 或 团体 的 喜事
开门	打开门
介入	进入 事件 之中 进行 干预
指令	指导 号令
打扮	修饰 外表
欺负	用 傲慢 的 态度 或 不讲道理 的 手法 恫吓 或 企图 胁迫
深化	向 更深 的 程度 发展
奉献	恭敬地 交付 献出
防盗	可 防止 被 扒窃 的
排序	又称 分类 按 关键字 大小 递增 或 递减 的 次序 对 文件 中 的 全部 记录 重新排列 的 过程 是 计算机 程序设计 中 的 一种 重要 运算 分 内部 排序 和 外部 排序 两大类 内部 排序 中 常用 的 方法 有 插入排序 冒泡排序 快速 排序 堆排序 基数排序 等
提取	通过 溶剂 如 乙醇 处理 蒸馏 脱水 经受 压力 或 离心力 作用 或 通过 其他 化学 或 机械 工艺 过程 从 物质 中 制取 如 组成 成分 或 汁液
怀念	思念 想念 ～ 念 ～ 旧 ～ 乡 ～ 古 缅 ～
借助	凭借 别人 或事 的 帮助 以 达到 目的 寡君 是 以愿 借助 焉 左传 襄公 四年 借助 他 的 指导 我 才 自修 完 了 大学 课程
建造	建筑 建造 教堂
外出	到 外面 去 特指 因事 到 外地 去
关联	互相 贯连
流浪	生活 没有 着落 到处 漂泊
康复	指病 后 身体 复原
上学	学生 到 学校 学习
截止	到 一定 期限 停止 进行
征集	寻求 收集
淘汰	用水 洗净 杂质
排除	消除 除掉
征收	政府 依法 向 人民 或 下属 收取
拉开	用力 使 双方 离开 拖开
招呼	用 言语 手势 或 其他 方式 招引 呼唤 唐   赵嘏 十无诗 寄桂府 杨 中丞 东省 南宫 兴不孤 几因 诗 酒谬 招呼 宋   苏轼 新 酿桂酒 诗 收拾 小山 藏社 瓮 招呼 明月 到芳 樽 老残游记 第二十回 派 人 到 省 城里 招呼 个 大 戏班子 来 并 招呼 北柱 楼 的 厨子 来 预备 留   老残   过年 魏巍 东方 第三部 第一章 我 在 屋子里 招呼 了 一声 他 竟 没有 听见
照明	用 灯光 照亮
洗澡	用 水洗 去 身上 的 污垢
遭受	受到 遭到
呼吁	因 痛苦 而 呼号 求助
克服	用 意志 和 力量 去 战胜 制伏
注视	注意 地看
喜悦	欢乐 快活
分散	分在 各处 不 集中
整改	整顿 并 改革
运气	把 力气 贯注 到 身体 某 一部分
解读	剖开 分开 ～ 剖分 ～ 瓦 ～～ 体
征服	用 武力 降服
花费	因 使用 而 消耗掉
定制	确定 的 做法 和 制度
包围	四面 围住 使 其 无法 逃跑
查处	同 查办
暂停	停止 一段时间
缓解	使 丧失 锋芒 使钝
亏损	支出 超过 收入 亏折 一般 分为 资金 亏损 和 物资 亏损
占地	占据 土地
洽谈	接洽 商谈
闪烁	光亮 晃动 不定 忽明忽暗
养殖	养育 繁殖
抵达	到达 目的地
大作	对人 著作 的 尊称
占用	占有 并 使用 占据 并 使用
采集	收集 材料 或 实物
委屈	受到 不 公平 的 待遇 心里 难过
发育	生物体 的 机体 和 构造 向 成熟 变化
莫名其妙	说不出 其中 的 奥妙 指 事情 很 奇怪 说不出 道理 来
行走	行路 走动
打量	仔细 地 察看 一个 人
整治	翻修 使 恢复 原样
行驶	车船 行进
追踪	追索 踪迹
苦笑	心里 不 高兴 而 勉强 做出 的 笑容
投稿	向 出版部门 报社 广播电台 等 寄 准备 发表 或 播出 的 稿件
折磨	动使 人 肉体上 精神 上受 痛苦
射击	用 枪炮 等 火器 对着 目标 发射
拯救	援助 使 脱离 危难 援救
拍照	照相
放开	弃置 一边 舍弃
自学	不是 在校 从师 受业 主要 靠 自己 独立 学习 毛泽东 在 春节 座谈会 上 的 谈话 高尔基   的 学问 完全 是 自学 的 据说 他 只 上 过 两年 小学
消化	食物 在 人 和 动物 体内 经过 物理 和 化学作用 而 变为 能够 溶解 于水 并 可以 被 机体 吸收 的 养料
缩小	使 在 规模 数量 范围 或 数目 上 减少 由大 变小
善于	在 某 方面 具有 特长
不许	不 允许 不让
损坏	由于 各种 原因 造成 的 物件 残破 使 之 失去 部分
下车	从 车辆 上 下来
下班	结束 每天 规定 时间 的 工作
服用	穿着 服饰 使用 物品
发货	厂商 发送 货品
相爱	互相 亲爱 友好
应急	满足 紧急 需要
讲究	注重 力求 完美
占有	占领 取得
挖掘	向下 挖以 发掘
丧失	失去
调动	指 兵力 的 调遣 布置
约束	束缠
流传	谣言 新闻 或 其他 信息 在 人们 中间 的 传播
罚款	处罚 违法者 或 违反 合同 者 以 一定 数量 的 钱
制约	一 事物 的 存在 变化 是 另 一 事物 存在 变化 的 先决条件 则 前者 制约 后者
打断	使 某 一 活动 语音 思绪 行动 中断
模仿	按照 现成 的 样子 做
失业	能够 工作 的 人 找 不到 工作
巩固	坚固 稳固 而 不 动摇
垄断	山脉 阻隔
留意	留心 注意
抱歉	心有 愧疚 不安 对不住 别人
倾向	倾心 向往
盗版	亦 作 盗版 盗印
讲解	解说 解释
结算	会计 用语 指 把 某 一时期 内 的 所有 收支 情况 进行 总结 核算
供电	对 一个 电路 输送 电尤指 通过 电路 输送
谈谈	深邃 貌
繁荣	草木 茂盛 也 指 经济 或 事业 蓬勃发展 昌盛
尽力	副 尽 着 最大 的 力气
动员	发动 人们 参加 某项 活动
抄袭	照抄 别人 的 当做 自己 的
笔记	用笔 所 做 的 记录
品味	品尝 滋味
办学	兴办 学校 集资 ~
扶持	帮助 支撑 照料
心动	心脏 的 跳动
难免	不 容易 避免 免不了 他 年纪 还 小 难免 幼稚 一点
毁灭	彻底 破坏 消灭
困扰	搅扰 使 感到 难办
上映	放映 指 电影 上演
抛弃	扔掉 不要 丢弃
发电	发出 电力 向 工业 企业 居民 和 农村 大规模 提供 电 一般 均 设有 固定 电厂
抑郁	忧愤 烦闷
审议	审查 讨论
逃避	逃走 避开 躲开 不 愿意 或 不敢 接触 的 事物
不堪	不能 胜任 不能 承当
超出	超越 超过
住宿	留宿 某处
误会	误解
主编	编辑 工作 的 主要 负责人 出版物 全体 编辑 人员 的 领导者
在意	留心 注意
封闭	中断 或 停止 服务
分成	按 成数 比例 分配 钱物
不等	有 差异 不 相同 不 一样
判决	封建时代 指 官府 断案 后 指 司法机关 对 审理 结束 的 案件 作出 裁决
抵抗	用 力量 制止 对方 的 进攻
描写	用 语言文字 表现 人 或事物
下岗	到 了 规定 时间 离开 岗位
自助	依靠 自己 的 力量 自己 学习 帮助 自己
在场	亲身 在 事情 发生 进行 的 地方
侵害	侵犯 损害
放过	犹 放弃
进军	军队 向 目的地 进发 也 泛指 人们 向 某个 目标 前进
赋予	交给 重任 使命 等
争夺	竞争 抢夺
祝贺	庆贺
昏迷	因 大脑 功能 严重 紊乱 而 长时间 失去知觉
涉嫌	有 跟 某件事 情 发生 牵连 的 嫌疑
激活	刺激 有机体 内 某种 物质 使 其 活跃 地 发挥作用
促使	推动 某物 或 某事 使 达到 一定 目的
困惑	感到 疑难 不知所措
晓得	知晓 了解
惩罚	惩戒 责罚 处罚
颁发	公布 发布
着手	开始 动手 进行
疲劳	疲乏 劳累
从业	从事 某种 职业 从业 已有 三十年
净化	清除 不好 的 或 不 需要 的 使 纯净
弥补	补偿 赔偿
失落	丢失 失掉
交代	接替 移交 万物 之始 阴阳 交代 尔雅 释山 泰山 为 东岳 疏及 岁 尽 交代 卫座 数千 人 皆 叩头 自 请愿 复留 共 更 一年 汉书 盖 宽饶 传 交代 工作
确立	牢固地 建立 或 树立
不定	副词 表示 不 肯定 后面 常有 表示 疑问 的 词 或 肯定 和 否定 相叠 的 词组
抗议	对 某人 某国 某 单位 的 言论 行为 或 措施 表示 强烈 反对
传世	流传 到 后世
来回	含有 以 相反 方向 交替 出动 的 活动
吩咐	动 口头 指派 或 命令
参展	犹 参拜
跳舞	通常 伴随 音乐 按照 有 节奏 的 步伐 而 移动 或者 单独 一个 人 或者 带 一个 舞伴 或者 以 集体 形式
崇拜	尊敬 佩服
启用	开始 使用
再现	过去 的 情况 再次出现
裁判	法 裁定 或 判决
中毒	受到 有毒 物质 的 侵害
崩溃	崩毁 溃散
管辖	管理 统辖 人员 事务 区域 案件 等
压抑	情绪 感情 低落
配方	为 某种 物质 如 药品 混合 咖啡 堵缝 填料 的 配料 提供 方法 和 配比 的 处方
称呼	把 叫做 称为
调控	调节 控制
企图	图谋 谋划 打算
心跳	心脏 跳动
反击	打击 进攻 的 敌人
还原	事物 恢复 到 原来 的 状况 或 形状
领取	取得 给予 的 东西
应聘	接受 聘问
猜测	猜度 揣测 凭 某些 线索 推断 猜度
通告	公开 地 通知
崛起	有 地势 突起 事物 突出 兴起 奋起 的 意思
调试	试验 并 调整 机器 仪器 等
增多	扩大 增长
荣获	光荣 获取
担忧	感到 忧虑 和 不安
标识	标示 识别
消毒	消灭 有害 微生物 以免 感染 消除 毒害
辞职	辞去 所 担任 的 职务
辐射	以波 或 粒子 的 形式 发射 辐射能 的 过程 亦 称 放射
击败	打败
奔驰	车马 等 快速 地 跑
充电	让 直流电 从 放电 相反 的 方向 通过 以使 蓄电池 中 活性 物质 恢复 作用
出声	发出声响
落地	物体 落 在 地上
援助	支援 帮助
头痛	凡 整个 头部 以及 头 的 前后 偏 侧部 的 疼痛 总称 头痛
报到	向 有关 部门 报告 自己 已到
分割	把 一个 整体 或有 联系 的 事物 强行 分开
授予	郑重 地 给予
着急	急躁 心中 不安
屏蔽	屏障 遮蔽
借口	假托 某种理由
避开	躲开 不 接触
借鉴	把 别的 人 或 事 当 镜子 对照 自己 以便 吸取经验 或 教训
终止	完结 停止
假设	暂时 认为
忙碌	忙 着 做事 不得 空闲
原谅	对 过失 错误 等 宽恕 谅解
变形	改变 原来 的 形态
绘画	作画 用笔 等 工具 墨 颜料 等 材料 在 纸 纺织物 墙壁 等 表面 上 画图 或作 其他 可视 的 形象
缴纳	向 公家 交付 规定 的 现金 或 实物 同 交纳
度假	指 旅行 或 在 某 胜地 度过 假期
合计	合在一起 计算
反抗	反对 并 抵抗
做人	指 待人接物
化妆	用 化妆品 修饰 容貌
统治	一个 人 或 一个 政权 为 维持 其 生存 与 发展 运用 权力 以 支配 其 领土 及 个人 的 行为
报复	对 批评 自己 或 损害 自己 利益 的 人 进行 攻击
下手	动手 着手
出错	发生 错误
赌博	用 财物 作注 以 一定 方式 争 输赢
塑造	用 语言文字 等 艺术 手段 描写 人物形象
召唤	把 人们 唤来
侮辱	欺侮 羞辱 使 蒙受 耻辱
评审	评议 审查
安置	敬语 请 休息 睡前 的 问候语
笑笑	花 盛开 貌
点播	又 叫 点种 播种 方法 之一 隔 一定 距离 挖 一个 坑点入 种子
好吃	形吃 起来 味道 好
去世	成年人 死去 因病 去世
协作	互相配合 共同完成 某项 任务
不在乎	不 放在心上
出击	向 敌人 发起 攻击
修理	整治 使 损坏 的 东西 恢复 原来 的 形状 结构 或 功能 等 修理 机器
分解	整体 分成 部分
起诉	提起 诉讼 尤指 指控 某种 罪行 或 犯法 行为 或 向 法庭 控告 要求 以 适当 的 法律 形式 惩罚 罪行 或 犯法 行为
资助	以 资财 钱物 相助
震动	使 颤动
出自	出于
失效	失去 原有 的 效力
震荡	处于 动荡 状态
志愿	志气 与 心愿
存放	寄存 储存 交付 照管
对照	相互 对比 参照
标准化	为 适应 科学 发展 和 组织 生产 的 需要 在 产品质量 品种 规格 零部件 通用 等 方面 规定 统一 的 技术标准 叫 标准化 标准化 可分 国际 或 全国 范围 的 标准化 及 工业部门 的 标准化
看待	对待 视为
放置	安放
提议	提出 供 考虑 开会 时 提出 供 讨论 决定
开工	工厂 开始 生产 或 工程 开始 进行
等候	等待
包裹	包扎 成件 的 包儿
打扰	干扰 扰乱 人心 或 注意力
意料	事先 对 情况 结果 等 的 估计 推测
搞好	通过 友好 的 献殷勤 及 礼物 使 顺从 使 乐于助人 使 软化
尽情	尽量 抒发 情感 不 受约束
制订	制定 拟订
征求	访求 征求意见
纠正	指 改正错误 不 公正 或 对 标准 的 偏离
总共	合在一起 一共
走路	步行
观赏	观看 欣赏
安心	心情 安定
难受	身体 感觉 不佳
向往	思慕 理想 追求
守护	看守 保护
专注	专心 注意 精神贯注
命名	以 某个 名字 或 头衔 称呼
滚动	同滚  
堕落	道德 方面 下落 至 可耻 或 可鄙 的 程度
感慨	心灵 受到 某种 感触 而 慨叹 感慨不已
颁布	公布 法令 条例 等 政府 机关 或 人民团体 将 其 研拟 的 法令 规章 行政 措施 和 所属 成员 的 权利义务 有关 的 诸 事宜 依法 公布 周知
转型	所谓 转型 是 指 事物 的 结构 形态 运转 模型 和 人们 观念 的 根本性 转变 过程
起床	从 床上 起来
跟随	常 作为 一个 侍从 或 随从 跟 在 后面
好似	像 大坝 好似 铜墙铁壁 顶住 了 洪水 的 冲击
发光	从 光源 发出 亮光
中断	半 中间 发生 阻隔 停顿 或 故障 而 断开
定时	按规定 时间 点火 的 或 定时 爆炸 的
承办	承接 经办
待机	等待 适当 的 机会 伺机
货运	由 运输业 者 提供 的 普通 货物运输 区别 于 通常 为 低价 发货 迟误 收取 装 转运 费 或 大宗 货物 最低 运价 的 快运 货物
监察	监督 考察 监督 检举
衡量	é á 的 又 音义 同 衡量 é á
捕捉	缉捕 捉拿
遵循	遵从 依照
争论	各执己见 互相 辩论
运转	沿着 一定 的 轨道 行动
爱国	热爱 自己 的 国家
馆藏	图书馆 或 博物馆 等 收藏
注入	泵入 灌入 或 流入
渗透	渗入 透过
导游	向导 引导 观光
前去	谓 到 某处 去 南史 梁武帝 纪今 以   南康   置 人 手中 彼 挟天子以令诸侯 节下 前去 为 人 所 使 此 岂 岁寒 之计 唐   戴司 颜江 上 雨 诗 非 不 欲 前去 此情 非 自由 明   唐顺之 阅视 军情 首疏兹 特命 尔 前去 儿女 英雄传 第三 六回安 老爷   这里 打发 来 人 又 专人 前去 道 答 就 便 打听 那边 的 消息 鲁迅 书信集 致孟十 还 今托友 送 上 大洋 二十五元 乞 先生 前去 买下 为托
发作	突然 发生 开始 起 作用
掩饰	掩盖 文饰
隔离	断绝 接触 断绝往来
放出	释放
处置	分别 事理 使 各得其所
环境保护	为了 防止 恶劣 的 气候 或 其他 废水 废气 废渣 等 环境因素 危害 而 对 人 或 设备 所作 的 保护
导向	使 事情 向 某个 方面 发展
指责	指出 过失 并 责备 指摘
揭开	使 暴露 出来
感应	物理学 名词 一个 物体 如 电导体 可 磁化 体 电路 内部 由于 另 一 类似 激发 物体 的 接近 但 不 接触 或者 由于 磁通 的 变化 而 产生 的 电荷 磁性 或 电动势
养成	培养 而 使 之 形成 或 成长 吕氏春秋 本生始 生之者 天 也 养成 之者 人 也 初刻 拍案惊奇 卷十他 年 十二岁 上 就 游 庠 的 养成 一 肚皮 的 学问 巴金 观察 人 我 养成 了 观察 人 的 习惯
播出	逃亡
变革	对 本质 的 改变 多指 制度 法度 而言
冷笑	含有 轻蔑 讥讽 无可奈何 愠怒 等 意味 的 笑
升起	向 上升
忧伤	忧愁 哀伤
起伏	上升 和 下降
开创	创立 开拓 创建
听取	接受 听 意见 反映 汇报 等
抢劫	以 暴力 掠夺
见识	指 明智地 正确 地 作出 判断 及 认识 的 能力
心痛	心脏 所在 部位 感觉 疼痛
相差	彼此 差别
倒霉	不良 状况 尤指 关于 健康 命运 或 前途 的 坏 状况
笼罩	广泛 覆盖 的 样子
储备	储存 准备
离不开	不能 分开
回避	设法 躲避
汇总	把 资料 票据 数据 等   汇集 到 一起
转化	向 反面 转化
整顿	使 紊乱 变 整齐 使 不 健全 的 健全 起来
保守	保存 守护
阴谋	暗中 策划 做 坏事
复发	在 变得 好 一些 以后 又 滑 回 或 退回 从前 的 状态 如 疾病 或 罪恶
过年	在 新年 或 春节 期间 进行 庆祝 等 活动
抓紧	牢牢 抓住 不 放松
穿越	跨过 越过 穿过
竣工	工程 完工
回落	回落 íò  水平 从 高处 下降 洪峰 回落 回落 íò  市场 价格 及 企业 活动 在 持续 急剧 上升 之后 的 降落
擅长	独具 某种 特长
邮寄	由 邮电局 寄递
增添	增加 加添
修订	编者 对 文章 如 古代 作家 的 著作 的 修改 订正
背叛	背离 叛变
编译	编写 和 翻译 外文 也 称 翻译者
传达	单位 门口 的 值班人员
反思	回头 反过来 思考 的 意思
专卖	某些 商品 由 国家 专营 机构 统一 管理 和 产销 任何 个人 和 单位 必须 经该 机构 批准 方可 生产 或 经销 专控 商品
不惜	不 顾惜
升值	提高 货币 的 含金量 或 对 外币 的 比价
自称	古代 的 自称 有 很多 例如 常用 吾 我余予 等 还有 帝王 专称 朕 孤寡 人 等 字 通常 都 可译 为 我 我 的 我们 我们 的 啊
损伤	损害 损伤 了 肩膀
上天	进入 天空 进入 太空
废话	没有 意义 的话
录制	录音 并 制作 或 录像 并 制作
表彰	表扬 并 嘉奖
欢喜	欢乐 心喜
停留	暂时 留在 某处 不 继续前进
充实	内容 充足 不虚
看清	清晰 地 看见 看清楚
异性	性别 不同 也 指 性别 不同 的 人
核算	核查 计算
在乎	放在心上 介意
承包	接受 工程 或 大宗 订货 等 任务 负责 按 合同规定 完成
选拔	按 条件 进行 挑选
显现	显露 露面
著作	撰述 古代 专指 撰写 诗文 包括 文学 与 学术 作品
计量	指 实现 单位 统一 量值 准确 可靠 的 活动
纠缠	相互 缠绕
点燃	引着 火使 燃烧
抵触	冲突 竞争
惊奇	感到 很 奇怪
心疼	因 喜爱 的 东西 或 人 受到 损害 而 感到痛苦 或 难受
指教	指点 教导 多 用作 请 人 提 批评 意见 的 套语
参照	参考 仿照
交叉	方向不同 的 几条 线或 条 状物 互相 穿过
强行	强制 进行
纳税	交税
构造	犹 捏造
打败	战胜 对方
过渡	事物 由 一个 阶段 逐渐 发展 而 转入 另 一个 阶段
查阅	检查 察看
往来	去 和 来
徘徊	在 一个 地方 来回 地 走
弥漫	布满 到处 充斥 着
施展	发挥 运用
重建	重新 建设 或 建立 重新组建
壮大	长大成人
拦截	阻拦 阻断
赞助	支持 并 协助
聆听	汉   扬雄 法言 五百 聆听 前世 清视 在 下 a莫近 於 斯 矣 后 多 用于 书面语 常指 仔细 注意 地 听
执政	掌管 国家 政事
审理	审查 和 处理 案件
表扬	对 好人好事 公开 称赞
发泄	尽量 发出
效力	约束力
制止	用 强力 阻止 强迫 停止
乃是	是 就是
会谈	双方 或 多方 共同 进行 的 商谈
信赖	信任 依赖
过期	超过 时限
分裂	整个 事物 分开 也 指使 整体 分开
示意	用 动作 表情 含蓄 的话 或 图形 表示 某种 意思
打架	相打 徒手格斗
规范化	使合于 一定 标准
受益	得到 好处
预约	预先 约定 时间
炒作	为 扩大 人 或事物 的 影响 而 通过 媒体 做 反复 的 宣传 经过 一番 新闻 ～ 这位 歌星 名气 大振
为难	难以 应付
迷惑	形 分不清 是非 弄 不 明白
步入	走进
收看	看电视
施行	执行 实施
依托	依靠 凭借
救助	拯救 和 帮助 救护 援助
解开	动 分开 打开 消除
思索	反复 思考 探索
引领	伸直 脖子   向 远处 眺望 形容 殷切 期待 的 样子
区分	划分 区别 辨别 分辨
陪伴	随同 做伴
演奏	用 乐器 表演
开头	事情 动作 等 最初 发生 开始
美化	装饰 点缀 使 美观
蔓延	向 四周 扩展 延伸
聚焦	使 光线 或 电子束 等 集中 于 一点
攻克	攻下 城镇 据点
存档	把 文件 资料 等 归档 存查
相识	互相 认识
停车	汽车 火车 等 按 正常 时刻表 停留 如搭运 或 卸下 乘客 车辆 停止 行驶
开会	召集 若干 人 议事 多人 聚集 于 一定 处所 议事 举行 会议 或 集会 有 会议 或 集会 参加 会议 或 集会   市政府 将 很快 开会研究 处理 这个 问题
住院	病人 住进 医院 接受 治疗 或 观察
加重	在 原有 基础 上 加大 重量
号称	以 某名 著称
追逐	指 迅速 积极 地 追寻 逃跑 的 东西
执业	律师 医生 会计 等 进行 业务 活动
获利	产生 利润
替换	更替 调换 倒换
评定	经过 评判 或 审核 来 决定
致使	导致 因 造成
改编	对原 作品 进行 的 重新 编写 前后 作品 的 体裁 往往 不同
歧视	不 平等 地 看待 清   薛福成 出使 四国 日记 光绪 十七年 二月 二十一日 朕 恭膺 天命 寅绍丕基 中外 一家 罔 有 歧视 巴金 家 二五 节省时间 便于工作 以及 减少 社会 上 歧视 女子 的 心理
分工	按 不同 技能 或 社会 要求 分别 做 各不相同 而 又 互相 补充 的 工作
创办	指办 事业 最初 的 步骤 通常 指 策划 方案 并 为 它 准备 基金 如 开创 工商业 机构 城镇 等
造就	培育 练就
缩短	使 距离 长度 或 时间 变短
会见	跟 别人 相见
地处	名 空间 的 一部分 地方
推销	推广 销路
脸红	脸 发红 多 形容 羞愧 害羞
抗拒	抵抗 并 拒绝
行使	使用 履行
供给	满足 社会 购买力 的 需要
沉思	深思
转发	批转 下发
生病	得病
谈论	以 谈话 的 方法 表示 对人对事 的 看法
书写	写 书写 工整
张开	使 合拢 的 东西 分开
共计	合 起来 计算
核实	检验 和 查证
发誓	庄严 地 说出 表示决心 的话
转动	转身 活动 身体 或 物体 的 某 部分 自由 活动
阻碍	阻力 障碍
奠定	建立 安置 使 稳固
出具	谓 以 某种 名义 开出 某种 证件 清   陈康祺郎 潜 纪闻 卷 二 乾隆   元年 经 侍郎   励宗万   奏请 嗣后 学习 期满 人员 令该 堂 官 出具 考语 分 三等 引见 蒯世勋 上海 英美 租界 在 太平天国 时代 三国 代表 并未 将 原意 致达仅 交出 中立 宣言 一件 并 由   威妥 玛   传语 令 其 亦 出具 文告 十月 年 第期 学校 那 方面 没有 问题 保证 会 出具 在校 的 证明
否定	暗示 两个 相互 排斥 的 事物 的 一方 为 另一方 所 取消 或 废除
拨号	打电话 时 的 转动 号码 盘
操纵	控制 开动机器 或 仪器 等
去掉	摆脱 掉 使 自身 摆脱
救援	拯救 援助
率领	带领
承接	承前 接后
附属	由 某 机构 所设 并 受 其管辖 的 单位
想念	动脑筋 思索 感 ～ 思 ～～ 法 ～ 象 配置 组合 而 创造 出新 形象 的 心理过程 ～ 入非 非异 ～ 天开 幻 ～
议论	对 某 问题 进行 评议 讨论
难看	看着 不 顺眼 不 好看
决战	双方 使用 主力 以 决定 胜负 的 战役 或 战斗
入选	中选 当选
说服	用 充分 理由 劝导 使人 心服
麻醉	用 药物 或 针刺 使 肌体 暂时 丧失 知觉 比喻 用 某种 手段 使人 认识 模糊 意志 消沉
索取	要求 得到 讨取
迷失	迷惑 弄错 分辨 不清   方向 道路 等
饰演	扮演
认知	认识 思维 或 知觉 的 自身 发展 包括 理解 和 推理 的 意识 官能 或 过程 靠 它 获得 关于 感觉 或 理念 的 知识
收缩	变小 变短 或 减少
强迫	施加压力 使 服从 迫使
涨价	物价上涨
伴奏	为 歌舞 表演 或 某种 乐器 奏乐 配合
抢救	在 危急情况 下 突击 救护
降临	到来 来临
处分	对 违反 法律 或 犯错误 的 人 按 情节 轻重 处罚
观光	去 参观 名胜
报导	见 报道
察看	细看 以求 了解 情况
投放	用 甩 撒 的 办法 放置 投放 鱼饵
生效	发生 效力
扣除	减去 总数 中 的 一部分
向着	旧时 河工 术语 水流 冲刷 亦 指 水流 冲刷 之处
养老	奉养 老人 养老送终
倡导	率先 提议 首倡
筹备	筹措 预备
不屑	认为 不 值得
揭晓	公布 考试 录取名单 泛指 把 事情 的 结果 公开出来
诅咒	原指 祈求 鬼神 加祸于 所 恨 的 人现 指 咒骂
值班	在 当值 的 班次 里 担任 工作
精通	透彻 理解 并能 熟练掌握
提倡	由于 事物 有 好 的 因素 而 倡议
得罪	é ì 的 又 音义 同 得罪 é ì
浮现	过去 经历 的 事情   再次 在 脑子里 显现
设想	想象 假想
嫉妒	因人 胜过 自己 而 产生 的 忌恨 心理
聘请	邀请 人 担任 职务
拜托	敬词 委托人 办 某事
逃跑	为 躲避 对 自己 不利 的 环境 或事物 而 逃离
报仇	报复 仇恨
兴起	因 感动 而 奋起
监理	监督管理 通典 职官 六初 秦   以 御史 监理 诸郡 谓之 监察 史前 汉书 平话 卷上   高皇   辛   吕后   设 治国 事萧何   监理 朝纲
流失	有用 的 物质 散失 掉 或 被 风水 带走
破产	按照 法律 正式 宣布 无力 偿还债务 由 司法部门 接收 其 财产 以 分给 债权人   这个 公司 破产 了
力争	极力 争辩 尽力 争取
改装	改变 设备 原来 的 结构 装置
出差	机关 部队 或 企事业 单位 的 工作人员 暂时 到 外地 办理 公事 去 北京 ~｜ 出 了 一个月 的 差
拆迁	把 原 建筑 拆除 住户 迁移 到 别处
到期	到 了 有关 的 一定 期限 或 界限
无知	不 懂 情理 缺乏 知识 年幼无知
摩擦	使用 压力 在 一 物体 表面 上摩动
振动	物体 的 全部 或 一部分 沿 直线 或 曲线 往返 颤动 有 一定 的 时间 规律 和 周期
展望	对 发展前途 的 预测 可以 展望 我 晚年 的 平静 生活
呼叫	大声 叫喊
改成	将 一种 用途 或 目的 改变 为 另 一种 用途 或 目的
发售	出售
救命	拯救 某人 的 生命 救助 有 生命危险 的 人
连结	衔接 连接
起步	开始 走 某项 工作 行动 等 开始 进行
理会	明白 理解
打听	请求 回答 或 要求 提供 消息 探听 消息
概括	归纳 总括 把 事物 的 共同 特点 归结 在 一起 加以 简明 地 叙述 扼要 重述
上报	向 上级 报告
假冒	以假充真
改正	纠正错误
化解	溶化 消解
观望	置身事外 静观 事态 发展
搞定	新型 口语 一种 年轻 的 语言 搞定 是 指 一种 行事 效率 的 肯定 方式 表示 自身 的 自信 并 工作效率 的 体现 说明 能够 按 要求 的 完成 任务 或 自我 肯定 的 外 在 语言 激励
扭曲	物体 因 外力作用 而 扭转 变形 也 用于 比喻
碰撞	两 物体 相向 运动 引起 猛撞 的 情形
后退	从 某 一 固定 的 确定 的 前方 居 高点 或 位置 退下来 或 退 到 更 远 的 线 上 或 位置 上
发信	邮寄 信件
选定	指定 或 选择
现任	现在 担任
免得	免去 省得
感悟	有所 感触 而 醒悟 或 领悟
来信	指 寄信 给 说话 者
倾听	认真 地 听取
展出	展览 出来
漫步	悠闲地 随意 走
品尝	细致 地 辨别 滋味 试图 味道
申明	郑重 地 说明
凝聚	气体 变浓 或 凝结
遥控	利用 无线电 有线 传输 或 声波 进行 的 远距离 控制
瞄准	射击 时 注视 目标 以期 命中
分行	动 各自 分道 行走
焦急	非常 着急
开辟	打通 开拓
夺冠	夺取 冠军 夺得 第一名
行事	办事 做事
务实	从事 实际 工作
匹配	成为 夫妇关系
发烧	体温 超过
公认	公众 所 承认 大家 一致 地 承认 公认 他 为 城市 的 第一 公民
等同	看作 相同
问候	问安 问好
抢先	争先 抢 在 前面
抚摸	用手 轻轻 摩挲 茅盾 幻灭 十二 少年 轻轻地 抚摸 自己 胸前 的 疮疤 大似 一个 艺术家 鉴赏 自己 的 得意 旧作 秦牧 花城 古战场 春晓 怀着 抚摸 一砖 一石 的 心情 我 走进 了   三元里 来到 里北 的   三元 古庙
变换	用 同类 之物 交换 或 代替
鄙视	轻视 看不起
保修	商店 或 工厂 售出 的 某些 商品 在 规定 期限内 免费 修理 保修 一年
出资	出钱
气愤	生气 愤恨
阐述	阐明 陈述
上扬	股市行情 上扬
加热	使 温度 升高
迟疑	犹豫不决
做梦	入睡 后 大脑皮层 未 完全 抑制 脑海中 出现 各种 奇幻 情景
改制	改变 形式 本质 或 质量
出入	出门 与 进门 进去
飞舞	在 空中 飞着 舞动
出血	血液 自 血管 或 心脏 外流 外出 的 血液 进入 组织 间隙 或 体腔 内称 内出血 流出 体表 外称 外出血
累积	聚积
统筹	通盘筹划
如意	符合 心意 万事如意 称心如意
经销	经售
放手	停止 掌管 转交 别人
预警	事先 发出 警报
上当	中 了 别人 的 奸计 而 受骗
下场	演员 或 运动员 退场
简化	使 复杂 的 变为 简单 的
栽培	种植 并 培育
隐瞒	隐讳 其事 不敢 表明 真相
创立	首先 建立 开始 建立
躲避	隐匿 避开 以免 遇到 某些 情况
招收	用 考试 或 其他 手续 接收 学员 学徒工 人 或 其他 工作人员
投降	停止 抵抗 放下 武器 向 对方 屈服
不快	心情 不 愉快
上车	登车
任职	担任 官职 担任 职务
去除	好像 用 渗析 移除
歌唱	歌颂 以 赞颂 或 好像 以 赞颂 表达
朝着	犹朝班 语本 左传 昭公 十一年 朝有 著定 杜预   注著定 朝内 列位 常处 谓之 表著 陆德明   释文 著 张虑 反 宋史 河渠 志三 陛下 方将 澄清 朝著 建立 事功 不先 诛 窜   昌龄 孟昌龄 父子 无以 昭示 天下 清   钱谦益 邹县 谒 孟子 庙 诗 妾 妇充 朝著 从 横树 师帅 参见 朝班
移植	将 秧苗 或 树木 移走 并 栽种 在 另 一个 地方
凝视	不 眨眼 地看
制服	军人 学生 等 穿 的 有 规定 式样 的 制服
启示	启发 开导 使 有所 领会
注射	用 注射器 将 药液 注入 体内
跨越	跨过 越过 超越 某个 界限
倒下	动 东西 从 高处 往下 倾倒
终结	结束 完结
争霸	争夺 霸权
任命	委任 下文 任用
反射	声波 光波 或 其他 电磁波 遇到 障碍物 或 别种 媒质 面而 折回
撰写	写作
预告	预先 告知
排队	呈现 整齐 的 线形 排列
呵护	呵 禁卫 护使 侵凌 者 不得 近
赤裸	亦 作 赤 倮 亦 作赤s 裸露 赤裸裸
吵架	剧烈地 争吵
束缚	捆绑 指 约束 限制
怀抱	藏于 怀中 心意 胸怀 怀抱 远大 的 理想
纯洁	纯粹 洁白 没有污点
作弊	用 欺骗 的 手段 做 不 合法 或 不合规定 的 事
抽烟	吸 纸烟 或 水管 烟
经纪	生意 做生意
排放	排泄 放出
相连	互相 连接 彼此 关联
法治	先秦 时期 法家 的 政治 思想 主张 以 法治 国
立足	站住脚 指能 住 下去 或 生存 下去
骚扰	使 不 安宁 扰乱
联网	若干 单个 的 设备 相互连接 成 网络 若干 较 小 的 网络 相互连接 成 更 大 的 网络 ～ 发电 ｜ 计算机 ～
编剧	编定 撰写 剧本 的 人
测验	用 一定 的 标准 和 方法 进行 检验 考查
不一	大 ～ 业 ～ 变
珍藏	珍重 地 收藏
饲养	对 动物 的 饲养 和 照料
体贴	对 别人 的 心理 或 境况 进行 了解 并 予以 关心 和 照料
雕刻	在 金属 木材 石头 等 上面 刻出 图形 装饰
后续	后面 接续而来
在职	正在 任职期间
改版	对照 已 改过 的 校样 改正 已 排版 中 的 错误
入手	着手 开始 做
通风	使 空气流通
奔跑	快速 地 跑
到手	拿到 手
逛街	口指 街头 散步 在 街上 闲逛
招募	征召 募集
起飞	飞机 火箭 或 鸟 离开 地面 或 水面
进门	走进 门
加班	在 规定 的 工作 时间 结束 后 增加 工作 时间 或 班次
不服	拒绝 服从
装潢	亦 作 装璜 装裱 字画 古时 装裱 书画 用 黄蘖 汁 染 的 纸 即 潢 纸 故称 南朝   梁   沉约 齐 禅林寺 尼净秀 行状 又 写 集众 经皆令 具足 装潢 染成 悉 自然 有 宋   姚宽 西溪 丛语 卷 下 齐民要术 有 装潢 纸法云 浸蘖 汁 入潢 凡潢 纸灭 白 便是 染则 年久色 暗盖染 黄 也 写 讫 入潢 辟 蠹 也 清   俞樾 茶香 室三钞 剪字   林文耀   中年 失明 乃 翦 纸 为 字势 飞动 若 龙蛇 点画 不 差毫  室 人 装璜 成轴易 薪米 以 自给 人称 之 曰   林翦 一本 作 装潢 一说 潢 犹池言 书画 周边 装饰 绫锦则 缘内 如池 装成 卷册 谓之 装潢 清   方以智 通雅 器用 潢 犹池 也 外加 缘则 内为 池装成 卷册 谓之 装潢 即表背 也 参阅   明   周嘉胄 装潢 志
补助	为 某 一 目标 提供 资金 方面 的 援助 市政府 为 该 计划 补助 了 万元
作曲	编写 音乐作品
中奖	奖券 的 号码 与 开奖 的 号码 相同 而 获奖 金 或 奖品
探测	探查 某物 确定 物体 辐射 化学 化合物 信号 等 是否 存在
追问	追根究底 地问 追查 南朝   陈   周弘正 和 庾肩吾 入道馆 逆愁 归 旧里 追问 斧 柯年 元 典章 户部 八 课程 但 有 答带 N盐 或  除 b 重及 支给 失次 刁蹬 盐商 者 随即 追问 是 实 郁达夫 过去 我 想起 了 在   上海   的 时候 的 她 的 那种 怪 脾气 所以 就 也 不再 追问
侦探	暗中 探查 机密 或 调查 案情 的 人
命中	名 生命 中
同等	相同 一样
酝酿	造酒 的 发酵 过程 比喻 做 准备 工作
惊醒	因受 惊动 而 醒来
进化	事物 逐渐 发展 变化 特指 生物 从 较 低级 较 简单 的 状态 向 较高级 较 复杂 的 状态 演变
害羞	感到 不好意思 难为情
期盼	期待 盼望
冶金	冶炼 金属
保卫	保护 使不受 侵犯
发呆	呈现出 呆 相 发楞
为首	当 领头 的 人 担任 领导
滚滚	大水 急速 翻腾 向前
发掘	把 埋藏 的 东西 挖掘 出来
开支	付出 钱
遗传	通过 细胞 染色体 由 祖先 向 后代 传递 的 品质
加深	程度 增加
问世	指新 作品 出版 跟 人们 见面
撤销	从 法律 上 取消
